time,job_id,num_gpu,submit_time,start_time,end_time,executed_time,JCT,duration,pending_time,preempt,promote
2345,application_1504131676014_19738,1,2276,2276,2345,69,69,69,0,0,0
2369,application_1504131676014_19851,1,2286,2286,2369,83,83,74,0,0,0
2389,application_1504131676014_19686,1,2271,2271,2389,118,118,117,0,0,0
2389,application_1504131676014_19647,1,2267,2267,2389,122,122,117,0,0,0
2389,application_1504131676014_19645,1,2267,2267,2389,122,122,117,0,0,0
2399,application_1504131676014_19693,1,2272,2272,2399,127,127,119,0,0,0
2399,application_1504131676014_19541,1,2257,2257,2399,142,142,115,0,0,0
2399,application_1504131676014_19780,1,2280,2280,2399,119,119,118,0,0,0
2399,application_1504131676014_19326,1,2226,2226,2399,173,173,116,0,0,0
2409,application_1504131676014_19330,1,2226,2226,2409,183,183,118,0,0,0
2409,application_1504131676014_19379,1,2231,2231,2409,178,178,169,0,0,0
2409,application_1504131676014_19356,1,2229,2229,2409,180,180,119,0,0,0
2409,application_1504131676014_19350,1,2228,2228,2409,181,181,180,0,0,0
2409,application_1504131676014_19844,1,2286,2286,2409,123,123,120,0,0,0
2409,application_1504131676014_19344,1,2228,2228,2409,181,181,179,0,0,0
2409,application_1504131676014_19864,1,2287,2287,2409,122,122,118,0,0,0
2421,application_1504131676014_19353,1,2229,2229,2421,192,192,190,0,0,0
2421,application_1504131676014_19322,1,2226,2226,2421,195,195,177,0,0,0
2446,application_1504131676014_19433,1,2237,2237,2446,209,209,204,0,0,0
2446,application_1504131676014_19650,1,2268,2268,2446,178,178,175,0,0,0
2446,application_1504131676014_19547,1,2257,2257,2446,189,189,179,0,0,0
2456,application_1504131676014_19663,1,2269,2269,2456,187,187,181,0,0,0
2456,application_1504131676014_19421,1,2236,2236,2456,220,220,213,0,0,0
2456,application_1504131676014_19698,1,2272,2272,2456,184,184,177,0,0,0
2456,application_1504131676014_19427,1,2236,2236,2456,220,220,211,0,0,0
2460,application_1504131676014_19598,1,2262,2262,2460,198,198,196,0,0,0
2460,application_1504131676014_19713,1,2274,2274,2460,186,186,183,0,0,0
2470,application_1504131676014_19862,1,2287,2287,2470,183,183,175,0,0,0
2470,application_1504131676014_19587,1,2260,2260,2470,210,210,203,0,0,0
2470,application_1504131676014_19586,1,2260,2260,2470,210,210,208,0,0,0
2480,application_1504131676014_19714,1,2274,2274,2480,206,206,198,0,0,0
2490,application_1504131676014_19840,1,2285,2285,2490,205,205,186,0,0,0
2490,application_1504131676014_19337,1,2227,2227,2490,263,263,191,0,0,0
2490,application_1504131676014_19786,1,2280,2280,2490,210,210,202,0,0,0
2490,application_1504131676014_19995,1,2305,2305,2490,185,185,167,0,0,0
2490,application_1504131676014_19974,1,2302,2302,2490,188,188,177,0,0,0
2510,application_1504131676014_19656,1,2268,2268,2510,242,242,168,0,0,0
2510,application_1504131676014_19746,1,2277,2277,2510,233,233,213,0,0,0
2510,application_1504131676014_19813,1,2283,2283,2510,227,227,207,0,0,0
2510,application_1504131676014_19784,1,2280,2280,2510,230,230,215,0,0,0
2510,application_1504131676014_20207,1,2426,2426,2510,84,84,62,0,0,0
2510,application_1504131676014_19804,1,2282,2282,2510,228,228,178,0,0,0
2510,application_1504131676014_19774,1,2279,2279,2510,231,231,207,0,0,0
2515,application_1504131676014_19707,1,2273,2273,2515,242,242,220,0,0,0
2516,application_1504131676014_19440,1,2238,2238,2516,278,278,215,0,0,0
2528,application_1504131676014_19470,1,2241,2241,2528,287,287,216,0,0,0
2528,application_1504131676014_19899,1,2291,2291,2528,237,237,201,0,0,0
2528,application_1504131676014_19924,1,2294,2294,2528,234,234,205,0,0,0
2528,application_1504131676014_19815,1,2283,2283,2528,245,245,217,0,0,0
2528,application_1504131676014_19721,1,2275,2275,2528,253,253,120,0,0,0
2548,application_1504131676014_19834,1,2285,2285,2548,263,263,223,0,0,0
2558,application_1504131676014_20063,1,2316,2316,2558,242,242,203,0,0,0
2568,application_1504131676014_20023,1,2312,2312,2568,256,256,209,0,0,0
2568,application_1504131676014_19985,1,2303,2303,2568,265,265,213,0,0,0
2588,application_1504131676014_19961,1,2300,2300,2588,288,288,213,0,0,0
2588,application_1504131676014_20040,1,2314,2314,2588,274,274,215,0,0,0
2588,application_1504131676014_19375,1,2231,2231,2588,357,357,291,0,0,0
2606,application_1504131676014_19397,1,2233,2233,2606,373,373,301,0,0,0
2606,application_1504131676014_19717,1,2274,2274,2606,332,332,267,0,0,0
2606,application_1504131676014_20073,1,2317,2317,2606,289,289,218,0,0,0
2606,application_1504131676014_20129,1,2339,2339,2606,267,267,211,0,0,0
2626,application_1504131676014_19682,1,2271,2271,2626,355,355,286,0,0,0
2626,application_1504131676014_20099,1,2334,2334,2626,292,292,216,0,0,0
2646,application_1504131676014_20102,1,2334,2334,2646,312,312,210,0,0,0
2646,application_1504131676014_20225,1,2516,2516,2646,130,130,70,0,0,0
2656,application_1504131676014_19524,1,2253,2253,2656,403,403,306,0,0,0
2666,application_1504131676014_19740,1,2276,2276,2666,390,390,200,0,0,0
2666,application_1504131676014_19863,1,2287,2287,2666,379,379,264,0,0,0
2686,application_1504131676014_19668,1,2269,2269,2686,417,417,292,0,0,0
2686,application_1504131676014_19957,1,2299,2299,2686,387,387,287,0,0,0
2696,application_1504131676014_19620,1,2264,2264,2696,432,432,345,0,0,0
2706,application_1504131676014_19502,1,2250,2250,2706,456,456,358,0,0,0
2706,application_1504131676014_19959,1,2299,2299,2706,407,407,288,0,0,0
2706,application_1504131676014_19966,1,2300,2300,2706,406,406,291,0,0,0
2706,application_1504131676014_19981,1,2302,2302,2706,404,404,288,0,0,0
2726,application_1504131676014_19955,1,2299,2299,2726,427,427,291,0,0,0
2746,application_1504131676014_19819,1,2283,2283,2746,463,463,351,0,0,0
2746,application_1504131676014_19808,1,2282,2282,2746,464,464,325,0,0,0
2746,application_1504131676014_19592,1,2261,2261,2746,485,485,355,0,0,0
2746,application_1504131676014_20242,1,2606,2606,2746,140,140,79,0,0,0
2766,application_1504131676014_19736,1,2276,2276,2766,490,490,348,0,0,0
2766,application_1504131676014_19999,1,2307,2307,2766,459,459,325,0,0,0
2779,application_1504131676014_19849,1,2286,2286,2779,493,493,351,0,0,0
2779,application_1504131676014_19442,1,2238,2238,2779,541,541,352,0,0,0
2779,application_1504131676014_19909,1,2292,2292,2779,487,487,358,0,0,0
2779,application_1504131676014_19419,1,2235,2235,2779,544,544,346,0,0,0
2779,application_1504131676014_19548,1,2257,2257,2779,522,522,352,0,0,0
2789,application_1504131676014_20155,1,2344,2344,2789,445,445,320,0,0,0
2799,application_1504131676014_19475,1,2242,2242,2799,557,557,346,0,0,0
2819,application_1504131676014_20095,1,2333,2333,2819,486,486,353,0,0,0
2829,application_1504131676014_19533,1,2256,2256,2829,573,573,291,0,0,0
2829,application_1504131676014_19916,1,2293,2293,2829,536,536,359,0,0,0
2846,application_1504131676014_20293,4,2769,2769,2846,77,77,72,0,0,0
2856,application_1504131676014_20049,1,2315,2315,2856,541,541,345,0,0,0
2906,application_1504131676014_20184,1,2349,2349,2906,557,557,349,0,0,0
2916,application_1504131676014_20021,1,2312,2312,2916,604,604,322,0,0,0
2916,application_1504131676014_20311,4,2846,2846,2916,70,70,63,0,0,0
2926,application_1504131676014_20312,1,2846,2846,2926,80,80,76,0,0,0
2930,application_1504131676014_20142,1,2340,2340,2930,590,590,346,0,0,0
2949,application_1504131676014_20158,1,2344,2344,2949,605,605,341,0,0,0
2949,application_1504131676014_20160,1,2345,2345,2949,604,604,206,0,0,0
2960,application_1504131676014_20281,1,2736,2736,2960,224,224,72,0,0,0
2980,application_1504131676014_20330,1,2896,2896,2980,84,84,79,0,0,0
3066,application_1504131676014_20448,1,2986,2986,3066,80,80,78,0,0,0
3076,application_1504131676014_20349,1,2930,2930,3076,146,146,144,0,0,0
3076,application_1504131676014_20355,1,2931,2931,3076,145,145,145,0,0,0
3076,application_1504131676014_20398,1,2936,2936,3076,140,140,139,0,0,0
3086,application_1504131676014_20422,1,2939,2939,3086,147,147,143,0,0,0
3126,application_1504131676014_20416,1,2938,2938,3126,188,188,181,0,0,0
3136,application_1504131676014_20472,1,3056,3056,3136,80,80,77,0,0,0
3162,application_1504131676014_20368,1,2933,2933,3162,229,229,228,0,0,0
3162,application_1504131676014_20358,1,2931,2931,3162,231,231,231,0,0,0
3172,application_1504131676014_20367,1,2933,2933,3172,239,239,231,0,0,0
3172,application_1504131676014_20361,1,2932,2932,3172,240,240,231,0,0,0
3186,application_1504131676014_20433,1,2950,2950,3186,236,236,236,0,0,0
3186,application_1504131676014_19790,1,2281,2281,3186,905,905,355,0,0,0
3212,application_1504131676014_20037,1,2314,2314,3212,898,898,334,0,0,0
3232,application_1504131676014_20045,1,2315,2315,3232,917,917,346,0,0,0
3242,application_1504131676014_20124,1,2338,2338,3242,904,904,354,0,0,0
3252,application_1504131676014_20541,1,3176,3176,3252,76,76,68,0,0,0
3258,application_1504131676014_20625,1,3186,3186,3258,72,72,69,0,0,0
3300,application_1504131676014_19953,1,2299,2299,3300,1001,1001,346,0,0,0
3324,application_1504131676014_20665,1,3261,3261,3324,63,63,57,0,0,0
3324,application_1504131676014_20664,1,3258,3258,3324,66,66,63,0,0,0
3343,application_1504131676014_20606,1,3182,3182,3343,161,161,157,0,0,0
3343,application_1504131676014_20612,1,3183,3183,3343,160,160,159,0,0,0
3353,application_1504131676014_20573,1,3179,3179,3353,174,174,173,0,0,0
3353,application_1504131676014_20598,1,3181,3181,3353,172,172,164,0,0,0
3366,application_1504131676014_20696,1,3293,3293,3366,73,73,70,0,0,0
3366,application_1504131676014_20701,1,3294,3294,3366,72,72,71,0,0,0
3366,application_1504131676014_20715,1,3296,3296,3366,70,70,69,0,0,0
3366,application_1504131676014_20738,1,3298,3298,3366,68,68,68,0,0,0
3385,application_1504131676014_20791,1,3326,3326,3385,59,59,57,0,0,0
3438,application_1504131676014_20590,1,3180,3180,3438,258,258,257,0,0,0
3444,application_1504131676014_20712,1,3296,3296,3444,148,148,73,0,0,0
3454,application_1504131676014_20579,1,3179,3179,3454,275,275,162,0,0,0
3454,application_1504131676014_20602,1,3182,3182,3454,272,272,158,0,0,0
3454,application_1504131676014_20589,1,3180,3180,3454,274,274,162,0,0,0
3454,application_1504131676014_20536,1,3176,3176,3454,278,278,275,0,0,0
3454,application_1504131676014_20600,1,3181,3181,3454,273,273,158,0,0,0
3454,application_1504131676014_20811,1,3366,3366,3454,88,88,85,0,0,0
3464,application_1504131676014_20700,1,3294,3294,3464,170,170,77,0,0,0
3464,application_1504131676014_20730,1,3297,3297,3464,167,167,74,0,0,0
3464,application_1504131676014_20769,1,3300,3300,3464,164,164,75,0,0,0
3474,application_1504131676014_20773,1,3301,3301,3474,173,173,72,0,0,0
3514,application_1504131676014_20741,1,3298,3298,3514,216,216,73,0,0,0
3524,application_1504131676014_20764,1,3300,3300,3524,224,224,79,0,0,0
3566,application_1504131676014_20998,2,3552,3552,3566,14,14,13,0,0,0
3651,application_1504131676014_21003,1,3566,3566,3651,85,85,83,0,0,0
3671,application_1504131676014_21008,1,3586,3586,3671,85,85,77,0,0,0
3671,application_1504131676014_21010,1,3596,3596,3671,75,75,73,0,0,0
3689,application_1504131676014_21011,1,3606,3606,3689,83,83,82,0,0,0
3766,application_1504131676014_21027,1,3696,3696,3766,70,70,69,0,0,0
3886,application_1504131676014_20680,1,3292,3292,3886,594,594,573,0,0,0
3886,application_1504131676014_21076,2,3870,3870,3886,16,16,16,0,0,0
3916,application_1504131676014_21047,1,3776,3776,3916,140,140,139,0,0,0
3956,application_1504131676014_20681,1,3292,3292,3956,664,664,568,0,0,0
3956,application_1504131676014_20224,1,2515,2515,3956,1441,1441,1194,0,0,0
3959,application_1504131676014_21096,1,3886,3886,3959,73,73,72,0,0,0
4051,application_1504131676014_21217,2,4031,4031,4051,20,20,18,0,0,0
4085,application_1504131676014_21214,1,4016,4016,4085,69,69,69,0,0,0
4095,application_1504131676014_21205,1,3986,3986,4095,109,109,106,0,0,0
4105,application_1504131676014_21239,1,4085,4085,4105,20,20,20,0,0,0
4115,application_1504131676014_21194,1,3982,3982,4115,133,133,125,0,0,0
4115,application_1504131676014_20790,1,3324,3324,4115,791,791,666,0,0,0
4125,application_1504131676014_20775,1,3302,3302,4125,823,823,73,0,0,0
4145,application_1504131676014_21149,1,3965,3965,4145,180,180,180,0,0,0
4165,application_1504131676014_21125,1,3959,3959,4165,206,206,197,0,0,0
4175,application_1504131676014_21172,1,3978,3978,4175,197,197,194,0,0,0
4246,application_1504131676014_21189,1,3980,3980,4246,266,266,259,0,0,0
4256,application_1504131676014_21296,1,4186,4186,4256,70,70,64,0,0,0
4276,application_1504131676014_20817,1,3372,3372,4276,904,904,902,0,0,0
4286,application_1504131676014_20832,1,3376,3376,4286,910,910,907,0,0,0
4296,application_1504131676014_21144,1,3961,3961,4296,335,335,334,0,0,0
4296,application_1504131676014_20829,1,3376,3376,4296,920,920,917,0,0,0
4316,application_1504131676014_21142,1,3961,3961,4316,355,355,349,0,0,0
4316,application_1504131676014_21312,1,4226,4226,4316,90,90,85,0,0,0
4316,application_1504131676014_20862,1,3387,3387,4316,929,929,928,0,0,0
4346,application_1504131676014_20848,1,3380,3380,4346,966,966,962,0,0,0
4356,application_1504131676014_20912,1,3398,3398,4356,958,958,951,0,0,0
4376,application_1504131676014_21121,1,3956,3956,4376,420,420,76,0,0,0
4397,application_1504131676014_21351,1,4306,4306,4397,91,91,84,0,0,0
4397,application_1504131676014_21355,1,4316,4316,4397,81,81,73,0,0,0
4416,application_1504131676014_21382,1,4346,4346,4416,70,70,69,0,0,0
4456,application_1504131676014_20810,1,3361,3361,4456,1095,1095,1088,0,0,0
4516,application_1504131676014_20633,1,3202,3202,4516,1314,1314,1220,0,0,0
4536,application_1504131676014_21400,1,4416,4416,4536,120,120,72,0,0,0
4538,application_1504131676014_20782,1,3308,3308,4538,1230,1230,470,0,0,0
4540,application_1504131676014_21417,1,4466,4466,4540,74,74,74,0,0,0
4540,application_1504131676014_20853,1,3385,3385,4540,1155,1155,949,0,0,0
4557,application_1504131676014_21427,1,4476,4476,4557,81,81,74,0,0,0
4640,application_1504131676014_20878,1,3389,3389,4640,1251,1251,885,0,0,0
4654,application_1504131676014_21562,16,4610,4610,4654,44,44,42,0,0,0
4696,application_1504131676014_20825,1,3375,3375,4696,1321,1321,1079,0,0,0
4696,application_1504131676014_21432,1,4506,4506,4696,190,190,72,0,0,0
4712,application_1504131676014_20846,1,3380,3380,4712,1332,1332,874,0,0,0
4752,application_1504131676014_21438,1,4526,4526,4752,226,226,78,0,0,0
4796,application_1504131676014_21020,1,3651,3651,4796,1145,1145,348,0,0,0
4806,application_1504131676014_20227,1,2518,2518,4806,2288,2288,384,0,0,0
4816,application_1504131676014_21594,1,4666,4666,4816,150,150,78,0,0,0
4836,application_1504131676014_21602,1,4686,4686,4836,150,150,73,0,0,0
4836,application_1504131676014_21613,1,4696,4696,4836,140,140,74,0,0,0
4900,application_1504131676014_20886,1,3391,3391,4900,1509,1509,978,0,0,0
4900,application_1504131676014_21561,1,4608,4608,4900,292,292,155,0,0,0
4906,application_1504131676014_21669,1,4796,4796,4906,110,110,71,0,0,0
4906,application_1504131676014_20842,1,3380,3380,4906,1526,1526,938,0,0,0
4916,application_1504131676014_21665,1,4786,4786,4916,130,130,76,0,0,0
4950,application_1504131676014_21716,1,4875,4875,4950,75,75,69,0,0,0
4950,application_1504131676014_21643,1,4742,4742,4950,208,208,140,0,0,0
4952,application_1504131676014_21744,1,4877,4877,4952,75,75,70,0,0,0
4952,application_1504131676014_21723,1,4875,4875,4952,77,77,72,0,0,0
4957,application_1504131676014_21852,1,4886,4886,4957,71,71,70,0,0,0
4957,application_1504131676014_21809,1,4882,4882,4957,75,75,72,0,0,0
4957,application_1504131676014_21712,1,4874,4874,4957,83,83,71,0,0,0
4964,application_1504131676014_21816,1,4883,4883,4964,81,81,68,0,0,0
4964,application_1504131676014_21720,1,4875,4875,4964,89,89,71,0,0,0
4964,application_1504131676014_21798,1,4881,4881,4964,83,83,69,0,0,0
4964,application_1504131676014_21866,1,4887,4887,4964,77,77,76,0,0,0
4964,application_1504131676014_21828,1,4884,4884,4964,80,80,71,0,0,0
4967,application_1504131676014_21870,1,4887,4887,4967,80,80,73,0,0,0
4967,application_1504131676014_21850,1,4886,4886,4967,81,81,73,0,0,0
4970,application_1504131676014_21766,1,4879,4879,4970,91,91,71,0,0,0
4970,application_1504131676014_21835,1,4884,4884,4970,86,86,68,0,0,0
4970,application_1504131676014_21867,1,4887,4887,4970,83,83,70,0,0,0
4978,application_1504131676014_21740,1,4877,4877,4978,101,101,77,0,0,0
4978,application_1504131676014_21849,1,4886,4886,4978,92,92,75,0,0,0
4984,application_1504131676014_21751,1,4878,4878,4984,106,106,69,0,0,0
4986,application_1504131676014_21887,1,4888,4888,4986,98,98,76,0,0,0
4987,application_1504131676014_21761,1,4878,4878,4987,109,109,69,0,0,0
4987,application_1504131676014_21863,1,4886,4886,4987,101,101,68,0,0,0
5006,application_1504131676014_21855,1,4886,4886,5006,120,120,72,0,0,0
5107,application_1504131676014_22124,1,5006,5006,5107,101,101,73,0,0,0
5107,application_1504131676014_21892,1,4906,4906,5107,201,201,146,0,0,0
5156,application_1504131676014_22225,1,5076,5076,5156,80,80,71,0,0,0
5237,application_1504131676014_20876,1,3389,3389,5237,1848,1848,928,0,0,0
5247,application_1504131676014_21681,2,4852,5227,5247,20,395,17,375,0,0
5287,application_1504131676014_20874,1,3389,3389,5287,1898,1898,890,0,0,0
5307,application_1504131676014_22309,1,5186,5186,5307,121,121,72,0,0,0
5307,application_1504131676014_20894,1,3393,3393,5307,1914,1914,1041,0,0,0
5307,application_1504131676014_21418,1,4466,4466,5307,841,841,592,0,0,0
5327,application_1504131676014_22324,1,5227,5227,5327,100,100,82,0,0,0
5337,application_1504131676014_21618,1,4702,4702,5337,635,635,500,0,0,0
5367,application_1504131676014_22165,1,5052,5052,5367,315,315,300,0,0,0
5376,application_1504131676014_22150,1,5051,5051,5376,325,325,302,0,0,0
5386,application_1504131676014_22148,1,5051,5051,5386,335,335,311,0,0,0
5396,application_1504131676014_20841,1,3380,3380,5396,2016,2016,1109,0,0,0
5413,application_1504131676014_22304,1,5182,5182,5413,231,231,185,0,0,0
5413,application_1504131676014_22255,1,5087,5087,5413,326,326,295,0,0,0
5423,application_1504131676014_21770,1,4879,4879,5423,544,544,459,0,0,0
5433,application_1504131676014_22222,1,5076,5076,5433,357,357,313,0,0,0
5433,application_1504131676014_22305,1,5182,5182,5433,251,251,220,0,0,0
5443,application_1504131676014_22223,1,5076,5076,5443,367,367,301,0,0,0
5443,application_1504131676014_21888,1,4890,4890,5443,553,553,461,0,0,0
5455,application_1504131676014_22308,1,5186,5186,5455,269,269,232,0,0,0
5475,application_1504131676014_22299,1,5181,5181,5475,294,294,249,0,0,0
5485,application_1504131676014_22364,1,5376,5376,5485,109,109,70,0,0,0
5495,application_1504131676014_21702,1,4873,4873,5495,622,622,544,0,0,0
5515,application_1504131676014_21788,1,4881,4881,5515,634,634,545,0,0,0
5577,application_1504131676014_22316,1,5197,5197,5577,380,380,314,0,0,0
5626,application_1504131676014_22141,1,5050,5050,5626,576,576,512,0,0,0
5646,application_1504131676014_22419,1,5536,5536,5646,110,110,73,0,0,0
5666,application_1504131676014_22161,1,5052,5052,5666,614,614,509,0,0,0
5676,application_1504131676014_21698,1,4873,4873,5676,803,803,606,0,0,0
5686,application_1504131676014_22194,1,5073,5073,5686,613,613,511,0,0,0
5706,application_1504131676014_22243,1,5085,5085,5706,621,621,516,0,0,0
5706,application_1504131676014_22240,1,5085,5085,5706,621,621,509,0,0,0
5706,application_1504131676014_22175,1,5060,5060,5706,646,646,499,0,0,0
5750,application_1504131676014_22452,1,5596,5596,5750,154,154,74,0,0,0
5766,application_1504131676014_22479,1,5626,5626,5766,140,140,84,0,0,0
5846,application_1504131676014_22517,1,5696,5696,5846,150,150,82,0,0,0
5876,application_1504131676014_22421,1,5540,5540,5876,336,336,251,0,0,0
5936,application_1504131676014_22578,1,5766,5766,5936,170,170,90,0,0,0
5936,application_1504131676014_22706,1,5846,5846,5936,90,90,66,0,0,0
5959,application_1504131676014_22371,1,5403,5403,5959,556,556,357,0,0,0
6059,application_1504131676014_22964,1,5936,5936,6059,123,123,77,0,0,0
6069,application_1504131676014_21526,1,4542,4542,6069,1527,1527,1109,0,0,0
6074,application_1504131676014_22523,1,5716,5716,6074,358,358,206,0,0,0
6074,application_1504131676014_20795,1,3333,3333,6074,2741,2741,2265,0,0,0
6074,application_1504131676014_21391,1,4377,4377,6074,1697,1697,1123,0,0,0
6074,application_1504131676014_22079,1,4983,4983,6074,1091,1091,877,0,0,0
6076,application_1504131676014_21520,1,4541,4541,6076,1535,1535,1093,0,0,0
6146,application_1504131676014_21977,1,4952,4952,6146,1194,1194,902,0,0,0
6146,application_1504131676014_22544,1,5720,5720,6146,426,426,261,0,0,0
6156,application_1504131676014_23018,1,6076,6076,6156,80,80,79,0,0,0
6182,application_1504131676014_20784,1,3315,3315,6182,2867,2867,2294,0,0,0
6182,application_1504131676014_21515,1,4540,4540,6182,1642,1642,1190,0,0,0
6182,application_1504131676014_22089,1,4985,4985,6182,1197,1197,896,0,0,0
6182,application_1504131676014_22385,1,5445,5445,6182,737,737,434,0,0,0
6222,application_1504131676014_22101,1,4987,4987,6222,1235,1235,878,0,0,0
6222,application_1504131676014_21931,1,4941,4941,6222,1281,1281,906,0,0,0
6222,application_1504131676014_22077,1,4982,4982,6222,1240,1240,918,0,0,0
6232,application_1504131676014_23016,2,6074,6222,6232,10,158,7,148,0,0
6242,application_1504131676014_22016,1,4964,4964,6242,1278,1278,892,0,0,0
6242,application_1504131676014_21968,1,4950,4950,6242,1292,1292,951,0,0,0
6242,application_1504131676014_22589,2,5778,6222,6242,20,464,11,444,0,0
6258,application_1504131676014_21999,1,4957,4957,6258,1301,1301,907,0,0,0
6258,application_1504131676014_22541,1,5719,5719,6258,539,539,323,0,0,0
6258,application_1504131676014_22966,2,5939,6242,6258,16,319,15,303,0,0
6300,application_1504131676014_22025,1,4967,4967,6300,1333,1333,974,0,0,0
6314,application_1504131676014_21481,1,4539,4539,6314,1775,1775,1119,0,0,0
6326,application_1504131676014_22034,1,4970,4970,6326,1356,1356,864,0,0,0
6333,application_1504131676014_23535,1,6261,6261,6333,72,72,55,0,0,0
6333,application_1504131676014_23551,1,6267,6267,6333,66,66,58,0,0,0
6342,application_1504131676014_23514,1,6258,6258,6342,84,84,55,0,0,0
6345,application_1504131676014_23528,1,6260,6260,6345,85,85,57,0,0,0
6354,application_1504131676014_23558,1,6295,6295,6354,59,59,46,0,0,0
6354,application_1504131676014_23566,1,6296,6296,6354,58,58,45,0,0,0
6354,application_1504131676014_23615,1,6306,6306,6354,48,48,43,0,0,0
6361,application_1504131676014_23631,1,6308,6308,6361,53,53,48,0,0,0
6361,application_1504131676014_23602,1,6303,6303,6361,58,58,46,0,0,0
6361,application_1504131676014_23579,1,6298,6298,6361,63,63,49,0,0,0
6361,application_1504131676014_23643,1,6311,6311,6361,50,50,44,0,0,0
6371,application_1504131676014_23582,1,6299,6299,6371,72,72,52,0,0,0
6371,application_1504131676014_23720,1,6322,6322,6371,49,49,44,0,0,0
6371,application_1504131676014_23692,1,6318,6318,6371,53,53,47,0,0,0
6371,application_1504131676014_23707,1,6320,6320,6371,51,51,45,0,0,0
6371,application_1504131676014_23663,1,6314,6314,6371,57,57,50,0,0,0
6371,application_1504131676014_23730,1,6323,6323,6371,48,48,46,0,0,0
6371,application_1504131676014_23649,1,6312,6312,6371,59,59,51,0,0,0
6371,application_1504131676014_23646,1,6311,6311,6371,60,60,47,0,0,0
6381,application_1504131676014_23779,1,6330,6330,6381,51,51,43,0,0,0
6381,application_1504131676014_23734,1,6323,6323,6381,58,58,44,0,0,0
6381,application_1504131676014_23613,1,6306,6306,6381,75,75,64,0,0,0
6381,application_1504131676014_23658,1,6313,6313,6381,68,68,49,0,0,0
6381,application_1504131676014_23617,1,6307,6307,6381,74,74,50,0,0,0
6381,application_1504131676014_23765,1,6328,6328,6381,53,53,45,0,0,0
6381,application_1504131676014_23706,1,6320,6320,6381,61,61,46,0,0,0
6381,application_1504131676014_23749,1,6326,6326,6381,55,55,47,0,0,0
6381,application_1504131676014_23718,1,6321,6321,6381,60,60,48,0,0,0
6381,application_1504131676014_23593,1,6301,6301,6381,80,80,60,0,0,0
6381,application_1504131676014_23970,2,6361,6361,6381,20,20,16,0,0,0
6391,application_1504131676014_23747,1,6326,6326,6391,65,65,59,0,0,0
6391,application_1504131676014_23793,1,6332,6332,6391,59,59,55,0,0,0
6391,application_1504131676014_23603,1,6304,6304,6391,87,87,48,0,0,0
6391,application_1504131676014_23711,1,6320,6320,6391,71,71,51,0,0,0
6391,application_1504131676014_23814,1,6335,6335,6391,56,56,50,0,0,0
6391,application_1504131676014_23827,1,6337,6337,6391,54,54,52,0,0,0
6391,application_1504131676014_23583,1,6299,6299,6391,92,92,49,0,0,0
6401,application_1504131676014_23916,1,6348,6348,6401,53,53,47,0,0,0
6401,application_1504131676014_23774,1,6329,6329,6401,72,72,62,0,0,0
6401,application_1504131676014_23855,1,6340,6340,6401,61,61,47,0,0,0
6401,application_1504131676014_23845,1,6339,6339,6401,62,62,43,0,0,0
6401,application_1504131676014_23795,1,6333,6333,6401,68,68,62,0,0,0
6401,application_1504131676014_23859,1,6341,6341,6401,60,60,45,0,0,0
6401,application_1504131676014_23811,1,6334,6334,6401,67,67,60,0,0,0
6408,application_1504131676014_23923,1,6348,6348,6408,60,60,43,0,0,0
6409,application_1504131676014_23927,1,6348,6348,6409,61,61,52,0,0,0
6416,application_1504131676014_23899,1,6345,6345,6416,71,71,63,0,0,0
6419,application_1504131676014_23917,1,6348,6348,6419,71,71,60,0,0,0
6422,application_1504131676014_23959,1,6354,6354,6422,68,68,45,0,0,0
6427,application_1504131676014_23921,1,6348,6348,6427,79,79,49,0,0,0
6429,application_1504131676014_21491,1,4539,4539,6429,1890,1890,1326,0,0,0
6432,application_1504131676014_23830,1,6337,6337,6432,95,95,45,0,0,0
6442,application_1504131676014_23826,1,6336,6336,6442,106,106,79,0,0,0
6442,application_1504131676014_23864,1,6342,6342,6442,100,100,50,0,0,0
6442,application_1504131676014_23968,1,6356,6356,6442,86,86,71,0,0,0
6452,application_1504131676014_21475,1,4538,4538,6452,1914,1914,1398,0,0,0
6452,application_1504131676014_23590,1,6300,6300,6452,152,152,95,0,0,0
6462,application_1504131676014_24019,1,6412,6412,6462,50,50,47,0,0,0
6462,application_1504131676014_21445,1,4536,4536,6462,1926,1926,1352,0,0,0
6462,application_1504131676014_21507,1,4540,4540,6462,1922,1922,1281,0,0,0
6472,application_1504131676014_24054,1,6418,6418,6472,54,54,53,0,0,0
6472,application_1504131676014_24101,1,6427,6427,6472,45,45,45,0,0,0
6472,application_1504131676014_24011,1,6411,6411,6472,61,61,56,0,0,0
6472,application_1504131676014_24023,1,6413,6413,6472,59,59,54,0,0,0
6472,application_1504131676014_24081,1,6424,6424,6472,48,48,44,0,0,0
6472,application_1504131676014_24002,1,6409,6409,6472,63,63,50,0,0,0
6482,application_1504131676014_24100,1,6427,6427,6482,55,55,49,0,0,0
6482,application_1504131676014_24074,1,6422,6422,6482,60,60,55,0,0,0
6482,application_1504131676014_24006,1,6410,6410,6482,72,72,57,0,0,0
6482,application_1504131676014_24033,1,6414,6414,6482,68,68,46,0,0,0
6482,application_1504131676014_24004,1,6410,6410,6482,72,72,53,0,0,0
6482,application_1504131676014_24073,1,6422,6422,6482,60,60,49,0,0,0
6482,application_1504131676014_24096,1,6426,6426,6482,56,56,53,0,0,0
6482,application_1504131676014_24001,1,6409,6409,6482,73,73,50,0,0,0
6482,application_1504131676014_24060,1,6418,6418,6482,64,64,56,0,0,0
6482,application_1504131676014_23994,1,6408,6408,6482,74,74,65,0,0,0
6482,application_1504131676014_24046,1,6416,6416,6482,66,66,50,0,0,0
6492,application_1504131676014_24083,1,6424,6424,6492,68,68,54,0,0,0
6502,application_1504131676014_24057,1,6418,6418,6502,84,84,65,0,0,0
6502,application_1504131676014_24153,1,6432,6432,6502,70,70,47,0,0,0
6502,application_1504131676014_24112,1,6427,6427,6502,75,75,58,0,0,0
6502,application_1504131676014_24050,1,6417,6417,6502,85,85,51,0,0,0
6502,application_1504131676014_21900,1,4922,4922,6502,1580,1580,1182,0,0,0
6502,application_1504131676014_24111,1,6427,6427,6502,75,75,60,0,0,0
6512,application_1504131676014_24066,1,6419,6419,6512,93,93,59,0,0,0
6522,application_1504131676014_24099,1,6427,6427,6522,95,95,49,0,0,0
6522,application_1504131676014_24113,1,6427,6427,6522,95,95,59,0,0,0
6522,application_1504131676014_24059,1,6418,6418,6522,104,104,62,0,0,0
6532,application_1504131676014_24084,1,6424,6424,6532,108,108,69,0,0,0
6542,application_1504131676014_24151,1,6432,6432,6542,110,110,72,0,0,0
6562,application_1504131676014_21474,1,4538,4538,6562,2024,2024,1359,0,0,0
6582,application_1504131676014_24128,1,6429,6429,6582,153,153,61,0,0,0
6602,application_1504131676014_22065,1,4978,4978,6602,1624,1624,1133,0,0,0
6622,application_1504131676014_21912,1,4935,4935,6622,1687,1687,1155,0,0,0
6642,application_1504131676014_21451,1,4536,4536,6642,2106,2106,1493,0,0,0
6732,application_1504131676014_21539,1,4547,4547,6732,2185,2185,1520,0,0,0
6742,application_1504131676014_22093,1,4986,4986,6742,1756,1756,1191,0,0,0
6763,application_1504131676014_24285,2,6642,6742,6763,21,121,14,100,0,0
6953,application_1504131676014_21538,1,4547,4547,6953,2406,2406,1707,0,0,0
7046,application_1504131676014_24537,1,6886,6886,7046,160,160,83,0,0,0
7046,application_1504131676014_22085,1,4984,4984,7046,2062,2062,1367,0,0,0
7086,application_1504131676014_24584,1,6966,6966,7086,120,120,73,0,0,0
7106,application_1504131676014_24406,1,6778,6778,7106,328,328,168,0,0,0
7206,application_1504131676014_24701,1,7125,7125,7206,81,81,33,0,0,0
7208,application_1504131676014_24697,1,7125,7125,7208,83,83,34,0,0,0
7256,application_1504131676014_24674,1,7106,7106,7256,150,150,93,0,0,0
7266,application_1504131676014_24759,1,7208,7208,7266,58,58,27,0,0,0
7266,application_1504131676014_24528,1,6869,6869,7266,397,397,215,0,0,0
7271,application_1504131676014_24760,1,7209,7209,7271,62,62,36,0,0,0
7307,application_1504131676014_24749,1,7196,7196,7307,111,111,77,0,0,0
7347,application_1504131676014_24819,1,7256,7256,7347,91,91,81,0,0,0
7425,application_1504131676014_24903,1,7375,7375,7425,50,50,27,0,0,0
7506,application_1504131676014_24565,1,6923,6923,7506,583,583,368,0,0,0
7586,application_1504131676014_24945,1,7496,7496,7586,90,90,71,0,0,0
7648,application_1504131676014_24959,1,7526,7526,7648,122,122,73,0,0,0
7658,application_1504131676014_24838,1,7271,7271,7658,387,387,344,0,0,0
7696,application_1504131676014_24839,1,7271,7271,7696,425,425,382,0,0,0
7696,application_1504131676014_24975,1,7556,7556,7696,140,140,84,0,0,0
7836,application_1504131676014_21983,1,4954,4954,7836,2882,2882,1957,0,0,0
7856,application_1504131676014_25004,1,7625,7625,7856,231,231,189,0,0,0
7906,application_1504131676014_25014,1,7666,7666,7906,240,240,73,0,0,0
7916,application_1504131676014_25029,1,7706,7706,7916,210,210,81,0,0,0
7926,application_1504131676014_24715,1,7136,7136,7926,790,790,678,0,0,0
7966,application_1504131676014_24769,1,7211,7211,7966,755,755,657,0,0,0
7986,application_1504131676014_25088,2,7967,7967,7986,19,19,19,0,0,0
7996,application_1504131676014_24782,1,7224,7224,7996,772,772,692,0,0,0
7996,application_1504131676014_25053,1,7816,7816,7996,180,180,71,0,0,0
7996,application_1504131676014_24789,1,7225,7225,7996,771,771,660,0,0,0
8036,application_1504131676014_24784,1,7224,7224,8036,812,812,723,0,0,0
8056,application_1504131676014_25087,1,7966,7966,8056,90,90,75,0,0,0
8076,application_1504131676014_24800,1,7237,7237,8076,839,839,661,0,0,0
8123,application_1504131676014_25089,1,7976,7976,8123,147,147,77,0,0,0
8123,application_1504131676014_11361,1,367,367,8123,7756,7756,5441,0,0,0
8153,application_1504131676014_25098,1,8056,8056,8153,97,97,79,0,0,0
8153,application_1504131676014_24996,1,7607,7607,8153,546,546,485,0,0,0
8173,application_1504131676014_24742,1,7187,7187,8173,986,986,845,0,0,0
8196,application_1504131676014_24874,1,7358,7358,8196,838,838,810,0,0,0
8206,application_1504131676014_25103,1,8106,8106,8206,100,100,84,0,0,0
8206,application_1504131676014_24902,1,7368,7368,8206,838,838,757,0,0,0
8216,application_1504131676014_24455,1,6791,6791,8216,1425,1425,1003,0,0,0
8276,application_1504131676014_21024,1,3679,3679,8276,4597,4597,2530,0,0,0
8296,application_1504131676014_25123,1,8186,8186,8296,110,110,80,0,0,0
8320,application_1504131676014_24877,1,7359,7359,8320,961,961,798,0,0,0
8340,application_1504131676014_25155,2,8311,8311,8340,29,29,20,0,0,0
8366,application_1504131676014_25144,1,8296,8296,8366,70,70,70,0,0,0
8386,application_1504131676014_24768,1,7211,7211,8386,1175,1175,819,0,0,0
8396,application_1504131676014_24884,1,7360,7360,8396,1036,1036,821,0,0,0
8426,application_1504131676014_25221,1,8346,8346,8426,80,80,76,0,0,0
8436,application_1504131676014_25138,1,8256,8256,8436,180,180,75,0,0,0
8456,application_1504131676014_25197,1,8320,8320,8456,136,136,40,0,0,0
8466,application_1504131676014_25125,1,8196,8196,8466,270,270,147,0,0,0
8486,application_1504131676014_22668,1,5817,5817,8486,2669,2669,1922,0,0,0
8532,application_1504131676014_25145,1,8306,8306,8532,226,226,77,0,0,0
8548,application_1504131676014_24529,1,6869,6869,8548,1679,1679,1236,0,0,0
8584,application_1504131676014_24478,1,6794,6794,8584,1790,1790,1163,0,0,0
8614,application_1504131676014_22436,1,5567,5567,8614,3047,3047,2138,0,0,0
8624,application_1504131676014_24890,1,7360,7360,8624,1264,1264,879,0,0,0
8634,application_1506638472019_0026,1,8556,8556,8634,78,78,66,0,0,0
8664,application_1506638472019_0029,1,8566,8566,8664,98,98,78,0,0,0
8738,application_1506638472019_0034,1,8578,8578,8738,160,160,149,0,0,0
8846,application_1506638472019_0154,2,8824,8826,8846,20,22,12,2,0,0
8866,application_1506638472019_0118,1,8746,8746,8866,120,120,115,0,0,0
8896,application_1506638472019_0036,1,8584,8584,8896,312,312,260,0,0,0
8906,application_1506638472019_0156,1,8826,8826,8906,80,80,69,0,0,0
8936,application_1506638472019_0015,1,8538,8538,8936,398,398,390,0,0,0
8936,application_1504131676014_21599,1,4677,4677,8936,4259,4259,3111,0,0,0
8946,application_1506638472019_0184,1,8915,8915,8946,31,31,25,0,0,0
8946,application_1506638472019_0180,1,8914,8914,8946,32,32,23,0,0,0
8966,application_1504131676014_25179,1,8317,8317,8966,649,649,393,0,0,0
8997,application_1506638472019_0172,1,8886,8886,8997,111,111,80,0,0,0
9007,application_1506638472019_0185,1,8916,8916,9007,91,91,87,0,0,0
9017,application_1506638472019_0176,1,8906,8906,9017,111,111,70,0,0,0
9027,application_1504131676014_24475,1,6794,6794,9027,2233,2233,1646,0,0,0
9217,application_1504131676014_24461,1,6792,6792,9217,2425,2425,1832,0,0,0
9274,application_1506638472019_0330,1,9220,9220,9274,54,54,47,0,0,0
9277,application_1506638472019_0332,1,9220,9220,9277,57,57,49,0,0,0
9285,application_1506638472019_0331,1,9220,9220,9285,65,65,51,0,0,0
9297,application_1506638472019_0369,1,9237,9237,9297,60,60,48,0,0,0
9297,application_1506638472019_0337,1,9221,9221,9297,76,76,46,0,0,0
9297,application_1506638472019_0380,1,9250,9250,9297,47,47,43,0,0,0
9311,application_1506638472019_0346,1,9223,9223,9311,88,88,51,0,0,0
9312,application_1506638472019_0395,1,9252,9252,9312,60,60,44,0,0,0
9313,application_1506638472019_0414,1,9255,9255,9313,58,58,52,0,0,0
9317,application_1506638472019_0389,1,9251,9251,9317,66,66,42,0,0,0
9324,application_1506638472019_0456,1,9261,9261,9324,63,63,39,0,0,0
9329,application_1506638472019_0412,1,9254,9254,9329,75,75,50,0,0,0
9329,application_1506638472019_0382,1,9250,9250,9329,79,79,47,0,0,0
9331,application_1506638472019_0366,1,9236,9236,9331,95,95,48,0,0,0
9345,application_1506638472019_0453,1,9260,9260,9345,85,85,50,0,0,0
9353,application_1506638472019_0406,1,9253,9253,9353,100,100,42,0,0,0
9367,application_1506638472019_0617,1,9312,9312,9367,55,55,39,0,0,0
9371,application_1506638472019_0497,1,9285,9285,9371,86,86,44,0,0,0
9387,application_1506638472019_0428,1,9256,9256,9387,131,131,47,0,0,0
9387,application_1506638472019_0467,1,9276,9276,9387,111,111,68,0,0,0
9387,application_1506638472019_0550,1,9301,9301,9387,86,86,40,0,0,0
9393,application_1506638472019_0626,1,9312,9312,9393,81,81,47,0,0,0
9393,application_1506638472019_0536,1,9298,9298,9393,95,95,42,0,0,0
9395,application_1506638472019_0543,1,9300,9300,9395,95,95,54,0,0,0
9396,application_1506638472019_0594,1,9307,9307,9396,89,89,43,0,0,0
9416,application_1506638472019_0555,1,9302,9302,9416,114,114,48,0,0,0
9416,application_1506638472019_0652,1,9316,9316,9416,100,100,44,0,0,0
9416,application_1506638472019_0565,1,9303,9303,9416,113,113,43,0,0,0
9416,application_1506638472019_1064,1,9395,9395,9416,21,21,14,0,0,0
9416,application_1506638472019_0700,1,9323,9323,9416,93,93,44,0,0,0
9426,application_1506638472019_0951,1,9365,9365,9426,61,61,47,0,0,0
9426,application_1506638472019_0583,1,9306,9306,9426,120,120,44,0,0,0
9426,application_1506638472019_0705,1,9323,9323,9426,103,103,49,0,0,0
9426,application_1506638472019_0729,1,9327,9327,9426,99,99,50,0,0,0
9426,application_1506638472019_0615,1,9311,9311,9426,115,115,50,0,0,0
9426,application_1506638472019_0717,1,9325,9325,9426,101,101,50,0,0,0
9426,application_1504131676014_23238,1,6162,6162,9426,3264,3264,2347,0,0,0
9426,application_1506638472019_0659,1,9317,9317,9426,109,109,40,0,0,0
9426,application_1506638472019_0926,1,9362,9362,9426,64,64,48,0,0,0
9426,application_1506638472019_0967,1,9368,9368,9426,58,58,47,0,0,0
9426,application_1506638472019_0737,1,9329,9329,9426,97,97,46,0,0,0
9436,application_1506638472019_0928,1,9363,9363,9436,73,73,45,0,0,0
9446,application_1506638472019_0876,1,9358,9358,9446,88,88,43,0,0,0
9446,application_1506638472019_0803,1,9345,9345,9446,101,101,49,0,0,0
9446,application_1506638472019_0845,1,9353,9353,9446,93,93,44,0,0,0
9446,application_1506638472019_1050,1,9393,9393,9446,53,53,12,0,0,0
9450,application_1506638472019_0644,1,9315,9315,9450,135,135,49,0,0,0
9450,application_1506638472019_0630,1,9313,9313,9450,137,137,39,0,0,0
9450,application_1506638472019_1008,1,9375,9375,9450,75,75,42,0,0,0
9466,application_1506638472019_0963,1,9368,9368,9466,98,98,45,0,0,0
9466,application_1506638472019_0684,1,9320,9320,9466,146,146,47,0,0,0
9466,application_1506638472019_0712,1,9324,9324,9466,142,142,37,0,0,0
9466,application_1506638472019_0766,1,9334,9334,9466,132,132,47,0,0,0
9466,application_1506638472019_0726,1,9327,9327,9466,139,139,53,0,0,0
9476,application_1506638472019_0789,1,9343,9343,9476,133,133,47,0,0,0
9476,application_1506638472019_0811,1,9346,9346,9476,130,130,42,0,0,0
9476,application_1506638472019_1019,1,9377,9377,9476,99,99,48,0,0,0
9476,application_1506638472019_0890,1,9358,9358,9476,118,118,45,0,0,0
9476,application_1506638472019_0604,1,9309,9309,9476,167,167,41,0,0,0
9476,application_1506638472019_1007,1,9375,9375,9476,101,101,41,0,0,0
9476,application_1506638472019_0577,1,9305,9305,9476,171,171,45,0,0,0
9496,application_1506638472019_0793,1,9343,9343,9496,153,153,48,0,0,0
9496,application_1506638472019_0663,1,9317,9317,9496,179,179,48,0,0,0
9496,application_1506638472019_0944,1,9364,9364,9496,132,132,41,0,0,0
9506,application_1506638472019_0947,1,9365,9365,9506,141,141,52,0,0,0
9506,application_1506638472019_0747,1,9331,9331,9506,175,175,52,0,0,0
9506,application_1506638472019_0957,1,9367,9367,9506,139,139,44,0,0,0
9506,application_1506638472019_0768,1,9334,9334,9506,172,172,40,0,0,0
9526,application_1506638472019_0986,1,9371,9371,9526,155,155,47,0,0,0
9526,application_1506638472019_1020,1,9377,9377,9526,149,149,44,0,0,0
9566,application_1504131676014_24436,1,6789,6789,9566,2777,2777,2163,0,0,0
9586,application_1506638472019_1087,1,9426,9426,9586,160,160,80,0,0,0
9604,application_1506638472019_1102,1,9476,9476,9604,128,128,67,0,0,0
9614,application_1506638472019_1095,1,9456,9456,9614,158,158,72,0,0,0
9614,application_1506638472019_0903,1,9359,9359,9614,255,255,137,0,0,0
9696,application_1506638472019_0956,1,9366,9366,9696,330,330,104,0,0,0
9806,application_1506638472019_1068,1,9396,9396,9806,410,410,214,0,0,0
9836,application_1506638472019_1205,1,9706,9706,9836,130,130,46,0,0,0
9836,application_1506638472019_1167,1,9658,9658,9836,178,178,76,0,0,0
9876,application_1506638472019_1215,1,9736,9736,9876,140,140,65,0,0,0
9912,application_1506638472019_1149,1,9626,9626,9912,286,286,155,0,0,0
9942,application_1506638472019_1181,1,9666,9666,9942,276,276,116,0,0,0
9992,application_1506638472019_1513,1,9889,9889,9992,103,103,55,0,0,0
10002,application_1504131676014_24435,1,6789,6789,10002,3213,3213,2196,0,0,0
10002,application_1506638472019_1150,1,9626,9626,10002,376,376,148,0,0,0
10063,application_1506638472019_1507,1,9886,9886,10063,177,177,76,0,0,0
10063,application_1506638472019_0528,1,9297,9297,10063,766,766,324,0,0,0
10127,application_1506638472019_1594,1,10043,10043,10127,84,84,62,0,0,0
10137,application_1504131676014_22431,1,5563,5563,10137,4574,4574,3086,0,0,0
10157,application_1504131676014_25009,1,7638,7638,10157,2519,2519,1594,0,0,0
10157,application_1506638472019_1517,1,9890,9890,10157,267,267,178,0,0,0
10167,application_1504131676014_24428,1,6788,6788,10167,3379,3379,2393,0,0,0
10236,application_1506638472019_1528,1,9892,9892,10236,344,344,237,0,0,0
10246,application_1504131676014_23804,1,6334,6334,10246,3912,3912,2563,0,0,0
10246,application_1506638472019_0916,8,9361,9361,10246,885,885,849,0,0,0
10266,application_1504131676014_24418,1,6787,6787,10266,3479,3479,2470,0,0,0
10266,application_1506638472019_1137,1,9594,9594,10266,672,672,380,0,0,0
10296,application_1506638472019_0396,1,9252,9252,10296,1044,1044,429,0,0,0
10346,application_1504131676014_24445,1,6790,6790,10346,3556,3556,2354,0,0,0
10373,application_1506638472019_1677,1,10191,10191,10373,182,182,28,0,0,0
10423,application_1506638472019_1689,1,10226,10226,10423,197,197,101,0,0,0
10506,application_1506638472019_1604,1,10066,10066,10506,440,440,64,0,0,0
10536,application_1506638472019_1756,1,10436,10436,10536,100,100,66,0,0,0
10549,application_1506638472019_1660,1,10176,10176,10549,373,373,70,0,0,0
10558,application_1504131676014_24557,1,6918,6918,10558,3640,3640,2233,0,0,0
10588,application_1506638472019_1817,2,10558,10568,10588,20,30,13,10,0,0
10618,application_1506638472019_0277,1,9102,9102,10618,1516,1516,956,0,0,0
10634,application_1506638472019_1836,2,10608,10608,10634,26,26,25,0,0,0
10676,application_1506638472019_1797,1,10506,10506,10676,170,170,67,0,0,0
10706,application_1506638472019_0484,1,9280,9280,10706,1426,1426,912,0,0,0
10806,application_1506638472019_1848,1,10676,10676,10806,130,130,70,0,0,0
10826,application_1506638472019_1846,1,10656,10656,10826,170,170,64,0,0,0
10876,application_1506638472019_0477,1,9278,9278,10876,1598,1598,1002,0,0,0
10886,application_1506638472019_0481,1,9279,9279,10886,1607,1607,970,0,0,0
10896,application_1506638472019_1849,1,10686,10686,10896,210,210,64,0,0,0
10986,application_1506638472019_0506,1,9288,9288,10986,1698,1698,940,0,0,0
11016,application_1506638472019_0849,1,9354,9354,11016,1662,1662,929,0,0,0
11056,application_1506638472019_0480,1,9279,9279,11056,1777,1777,958,0,0,0
11076,application_1506638472019_1012,1,9375,9375,11076,1701,1701,904,0,0,0
11146,application_1506638472019_0465,1,9274,9274,11146,1872,1872,956,0,0,0
11156,application_1506638472019_0483,1,9280,9280,11156,1876,1876,920,0,0,0
11156,application_1506638472019_1902,1,10976,10976,11156,180,180,90,0,0,0
11186,application_1506638472019_0473,1,9277,9277,11186,1909,1909,967,0,0,0
11186,application_1506638472019_1918,1,11056,11056,11186,130,130,69,0,0,0
11296,application_1506638472019_0148,1,8801,8801,11296,2495,2495,1533,0,0,0
11296,application_1506638472019_1930,1,11096,11096,11296,200,200,63,0,0,0
11336,application_1506638472019_1950,1,11186,11186,11336,150,150,65,0,0,0
11351,application_1506638472019_1006,1,9375,9375,11351,1976,1976,933,0,0,0
11356,application_1506638472019_1943,1,11156,11156,11356,200,200,62,0,0,0
11453,application_1506638472019_1959,1,11246,11246,11453,207,207,70,0,0,0
11473,application_1506638472019_0660,1,9317,9317,11473,2156,2156,952,0,0,0
11496,application_1506638472019_2011,1,11426,11426,11496,70,70,67,0,0,0
11516,application_1506638472019_1997,1,11356,11356,11516,160,160,74,0,0,0
11546,application_1506638472019_0774,1,9338,9338,11546,2208,2208,1173,0,0,0
11596,application_1506638472019_2195,1,11496,11496,11596,100,100,60,0,0,0
11626,application_1506638472019_2197,1,11506,11506,11626,120,120,65,0,0,0
11686,application_1506638472019_2179,1,11487,11487,11686,199,199,101,0,0,0
11726,application_1506638472019_0770,1,9336,9336,11726,2390,2390,1216,0,0,0
11726,application_1506638472019_1004,1,9375,9375,11726,2351,2351,944,0,0,0
11726,application_1506638472019_2210,1,11606,11606,11726,120,120,67,0,0,0
11796,application_1506638472019_2180,1,11487,11487,11796,309,309,219,0,0,0
11816,application_1506638472019_2221,1,11676,11676,11816,140,140,63,0,0,0
11886,application_1506638472019_2244,1,11796,11796,11886,90,90,90,0,0,0
11976,application_1506638472019_2141,1,11483,11483,11976,493,493,136,0,0,0
12015,application_1506638472019_2262,1,11906,11906,12015,109,109,68,0,0,0
12035,application_1506638472019_2326,2,12005,12015,12035,20,30,14,10,0,0
12055,application_1506638472019_2254,1,11856,11856,12055,199,199,66,0,0,0
12096,application_1506638472019_0149,1,8801,8801,12096,3295,3295,1544,0,0,0
12101,application_1506638472019_2274,1,11928,11928,12101,173,173,128,0,0,0
12151,application_1506638472019_2310,1,11966,11966,12151,185,185,72,0,0,0
12216,application_1506638472019_2275,1,11928,11928,12216,288,288,130,0,0,0
12266,application_1506638472019_2336,1,12076,12076,12266,190,190,74,0,0,0
12356,application_1506638472019_2353,1,12186,12186,12356,170,170,63,0,0,0
12416,application_1506638472019_1792,1,10496,10496,12416,1920,1920,1039,0,0,0
12551,application_1506638472019_2260,1,11901,11901,12551,650,650,348,0,0,0
12551,application_1506638472019_2387,1,12386,12386,12551,165,165,77,0,0,0
12806,application_1506638472019_2455,1,12696,12696,12806,110,110,78,0,0,0
12816,application_1506638472019_2452,1,12676,12676,12816,140,140,72,0,0,0
12836,application_1506638472019_2340,1,12101,12101,12836,735,735,325,0,0,0
12916,application_1506638472019_2445,1,12636,12636,12916,280,280,78,0,0,0
12936,application_1504131676014_24448,1,6790,6790,12936,6146,6146,3499,0,0,0
13037,application_1506638472019_2503,1,12936,12936,13037,101,101,82,0,0,0
13076,application_1506638472019_2501,1,12926,12926,13076,150,150,80,0,0,0
13116,application_1506638472019_2522,1,12976,12976,13116,140,140,81,0,0,0
13135,application_1506638472019_2492,1,12866,12866,13135,269,269,76,0,0,0
13135,application_1506638472019_1094,1,9450,9450,13135,3685,3685,1659,0,0,0
13206,application_1506638472019_2261,1,11901,11901,13206,1305,1305,416,0,0,0
13226,application_1506638472019_2542,1,13096,13096,13226,130,130,77,0,0,0
13261,application_1506638472019_2506,1,12946,12946,13261,315,315,84,0,0,0
13300,application_1506638472019_2548,2,13135,13287,13300,13,165,13,152,0,0
13302,application_1506638472019_2534,1,13046,13046,13302,256,256,65,0,0,0
13305,application_1506638472019_2544,1,13106,13106,13305,199,199,67,0,0,0
13309,application_1506638472019_2594,2,13261,13294,13309,15,48,15,33,0,0
13344,application_1504131676014_21579,1,4644,4644,13344,8700,8700,5285,0,0,0
13344,application_1506638472019_2562,1,13166,13166,13344,178,178,70,0,0,0
13458,application_1506638472019_2551,1,13146,13146,13458,312,312,73,0,0,0
13476,application_1506638472019_2609,1,13286,13286,13476,190,190,72,0,0,0
13506,application_1506638472019_3356,1,13396,13396,13506,110,110,50,0,0,0
13549,application_1506638472019_3330,1,13385,13385,13549,164,164,48,0,0,0
13549,application_1506638472019_3511,1,13436,13436,13549,113,113,59,0,0,0
13569,application_1506638472019_2176,1,11487,11487,13569,2082,2082,766,0,0,0
13596,application_1506638472019_3696,2,13578,13588,13596,8,18,6,10,0,0
13646,application_1506638472019_3387,1,13426,13426,13646,220,220,65,0,0,0
13725,application_1506638472019_3726,2,13705,13705,13725,20,20,16,0,0,0
13745,application_1506638472019_3699,1,13596,13596,13745,149,149,71,0,0,0
13909,application_1506638472019_3567,1,13476,13476,13909,433,433,71,0,0,0
13915,application_1506638472019_3704,1,13626,13626,13915,289,289,71,0,0,0
13995,application_1506638472019_3714,1,13676,13676,13995,319,319,69,0,0,0
14056,application_1506638472019_3753,1,13816,13816,14056,240,240,63,0,0,0
14067,application_1506638472019_3777,1,13909,13909,14067,158,158,60,0,0,0
14156,application_1506638472019_3870,1,14057,14057,14156,99,99,23,0,0,0
14176,application_1506638472019_3863,1,14057,14057,14176,119,119,30,0,0,0
14226,application_1506638472019_3366,1,13420,13420,14226,806,806,368,0,0,0
14279,application_1506638472019_3883,1,14076,14076,14279,203,203,65,0,0,0
14309,application_1506638472019_3956,1,14116,14116,14309,193,193,71,0,0,0
14390,application_1506638472019_4024,1,14316,14316,14390,74,74,67,0,0,0
14400,application_1506638472019_3915,1,14096,14096,14400,304,304,73,0,0,0
14516,application_1506638472019_3888,1,14086,14086,14516,430,430,67,0,0,0
14536,application_1506638472019_3990,1,14216,14216,14536,320,320,73,0,0,0
14658,application_1504131676014_24865,4,7347,7347,14658,7311,7311,4717,0,0,0
14668,application_1506638472019_3972,1,14146,14146,14668,522,522,77,0,0,0
14766,application_1506638472019_0275,1,9100,9100,14766,5666,5666,2268,0,0,0
14829,application_1506638472019_4204,1,14576,14576,14829,253,253,65,0,0,0
14856,application_1506638472019_4187,1,14506,14506,14856,350,350,75,0,0,0
14916,application_1506638472019_4229,1,14736,14736,14916,180,180,64,0,0,0
14936,application_1506638472019_4198,1,14546,14546,14936,390,390,71,0,0,0
15026,application_1506638472019_4290,1,14876,14876,15026,150,150,65,0,0,0
15036,application_1506638472019_4252,1,14789,14789,15036,247,247,99,0,0,0
15066,application_1506638472019_0167,1,8869,8869,15066,6197,6197,2585,0,0,0
15076,application_1506638472019_4320,1,14996,14996,15076,80,80,68,0,0,0
15096,application_1506638472019_4223,1,14696,14696,15096,400,400,78,0,0,0
15126,application_1506638472019_4215,1,14656,14656,15126,470,470,66,0,0,0
15126,application_1506638472019_4283,1,14846,14846,15126,280,280,72,0,0,0
15176,application_1506638472019_4318,1,14976,14976,15176,200,200,75,0,0,0
15196,application_1506638472019_4326,1,15056,15056,15196,140,140,66,0,0,0
15196,application_1506638472019_4303,1,14936,14936,15196,260,260,74,0,0,0
15266,application_1506638472019_4298,1,14906,14906,15266,360,360,83,0,0,0
15316,application_1506638472019_4329,1,15076,15076,15316,240,240,68,0,0,0
15496,application_1506638472019_4390,1,15296,15296,15496,200,200,71,0,0,0
15536,application_1506638472019_4382,1,15286,15286,15536,250,250,73,0,0,0
15566,application_1506638472019_4378,1,15266,15266,15566,300,300,73,0,0,0
15581,application_1506638472019_4351,1,15126,15126,15581,455,455,75,0,0,0
15626,application_1506638472019_4370,1,15226,15226,15626,400,400,60,0,0,0
15641,application_1506638472019_4513,1,15546,15546,15641,95,95,69,0,0,0
15711,application_1506638472019_3884,1,14077,14077,15711,1634,1634,516,0,0,0
15773,application_1506638472019_4478,1,15456,15456,15773,317,317,80,0,0,0
15783,application_1506638472019_4411,1,15356,15356,15783,427,427,69,0,0,0
15796,application_1506638472019_4728,1,15742,15742,15796,54,54,26,0,0,0
15833,application_1506638472019_3980,2,14184,15821,15833,12,1649,11,1637,0,0
15843,application_1506638472019_4304,2,14937,15821,15843,22,906,16,884,0,0
15886,application_1506638472019_4543,1,15616,15616,15886,270,270,77,0,0,0
15925,application_1506638472019_4499,1,15486,15486,15925,439,439,58,0,0,0
16028,application_1506638472019_5878,2,16018,16018,16028,10,10,8,0,0,0
16091,application_1506638472019_4893,1,15806,15806,16091,285,285,71,0,0,0
16146,application_1506638472019_4654,1,15726,15726,16146,420,420,72,0,0,0
16167,application_1506638472019_5820,1,15946,15946,16167,221,221,73,0,0,0
16187,application_1506638472019_4493,2,15468,16167,16187,20,719,19,699,0,0
16196,application_1506638472019_4546,1,15626,15626,16196,570,570,113,0,0,0
16228,application_1506638472019_5811,1,15926,15926,16228,302,302,71,0,0,0
16228,application_1506638472019_4806,1,15786,15786,16228,442,442,73,0,0,0
16246,application_1506638472019_5983,2,16229,16229,16246,17,17,13,0,0,0
16346,application_1506638472019_5877,1,16016,16016,16346,330,330,73,0,0,0
16406,application_1506638472019_5969,1,16196,16196,16406,210,210,68,0,0,0
16476,application_1506638472019_5897,1,16066,16066,16476,410,410,65,0,0,0
16566,application_1506638472019_1810,4,10539,10539,16566,6027,6027,3544,0,0,0
16586,application_1506638472019_6094,2,16570,16570,16586,16,16,14,0,0,0
16618,application_1506638472019_1612,1,10087,10087,16618,6531,6531,2281,0,0,0
16858,application_1506638472019_5988,1,16246,16246,16858,612,612,69,0,0,0
16868,application_1506638472019_6075,1,16506,16506,16868,362,362,69,0,0,0
16878,application_1506638472019_6011,1,16306,16306,16878,572,572,72,0,0,0
16919,application_1506638472019_6043,1,16337,16337,16919,582,582,172,0,0,0
16958,application_1506638472019_6045,1,16346,16346,16958,612,612,71,0,0,0
16968,application_1506638472019_6261,2,16948,16948,16968,20,20,19,0,0,0
16988,application_1504131676014_20627,1,3192,3192,16988,13796,13796,7691,0,0,0
16988,application_1506638472019_6129,1,16677,16677,16988,311,311,53,0,0,0
16993,application_1506638472019_6079,1,16526,16526,16993,467,467,78,0,0,0
17003,application_1506638472019_5996,1,16276,16276,17003,727,727,70,0,0,0
17036,application_1506638472019_6080,1,16536,16536,17036,500,500,75,0,0,0
17042,application_1506638472019_6101,1,16586,16586,17042,456,456,70,0,0,0
17050,application_1506638472019_6071,1,16466,16466,17050,584,584,82,0,0,0
17050,application_1506638472019_6128,1,16676,16676,17050,374,374,78,0,0,0
17105,application_1506638472019_6146,1,16716,16716,17105,389,389,73,0,0,0
17141,application_1504131676014_20632,1,3197,3197,17141,13944,13944,7626,0,0,0
17172,application_1506638472019_6151,1,16746,16746,17172,426,426,76,0,0,0
17205,application_1506638472019_6089,1,16556,16556,17205,649,649,73,0,0,0
17307,application_1506638472019_7009,1,17153,17153,17307,154,154,11,0,0,0
17359,application_1506638472019_3781,8,13915,13915,17359,3444,3444,914,0,0,0
17527,application_1506638472019_8411,1,17400,17400,17527,127,127,39,0,0,0
17527,application_1506638472019_6820,1,17136,17136,17527,391,391,66,0,0,0
17596,application_1506638472019_6206,1,16848,16848,17596,748,748,118,0,0,0
17634,application_1506638472019_8546,1,17419,17419,17634,215,215,52,0,0,0
17648,application_1506638472019_8408,1,17400,17400,17648,248,248,45,0,0,0
17690,application_1506638472019_7619,1,17236,17236,17690,454,454,44,0,0,0
17705,application_1506638472019_8495,1,17412,17412,17705,293,293,46,0,0,0
17725,application_1506638472019_6204,1,16848,16848,17725,877,877,117,0,0,0
17743,application_1506638472019_8455,1,17406,17406,17743,337,337,46,0,0,0
17743,application_1506638472019_8418,1,17401,17401,17743,342,342,46,0,0,0
17743,application_1506638472019_8690,1,17436,17436,17743,307,307,47,0,0,0
17766,application_1506638472019_8619,1,17428,17428,17766,338,338,48,0,0,0
17806,application_1506638472019_8359,1,17393,17393,17806,413,413,36,0,0,0
17822,application_1506638472019_8689,1,17436,17436,17822,386,386,42,0,0,0
17838,application_1506638472019_8548,1,17419,17419,17838,419,419,54,0,0,0
17865,application_1506638472019_8420,1,17401,17401,17865,464,464,46,0,0,0
17875,application_1506638472019_8547,1,17419,17419,17875,456,456,57,0,0,0
17875,application_1506638472019_8629,1,17429,17429,17875,446,446,61,0,0,0
17875,application_1506638472019_9252,1,17602,17602,17875,273,273,47,0,0,0
17895,application_1506638472019_8583,1,17424,17424,17895,471,471,44,0,0,0
17895,application_1506638472019_8427,1,17402,17402,17895,493,493,49,0,0,0
17903,application_1506638472019_9374,1,17618,17618,17903,285,285,52,0,0,0
17909,application_1506638472019_9494,1,17634,17634,17909,275,275,56,0,0,0
17909,application_1506638472019_9689,1,17664,17664,17909,245,245,54,0,0,0
17909,application_1506638472019_8423,1,17402,17402,17909,507,507,47,0,0,0
17909,application_1506638472019_8655,1,17432,17432,17909,477,477,42,0,0,0
17910,application_1506638472019_6002,1,16293,16293,17910,1617,1617,209,0,0,0
17916,application_1506638472019_9204,1,17596,17596,17916,320,320,48,0,0,0
17922,application_1506638472019_8473,1,17409,17409,17922,513,513,57,0,0,0
17922,application_1506638472019_9260,1,17603,17603,17922,319,319,59,0,0,0
17927,application_1506638472019_9409,1,17623,17623,17927,304,304,53,0,0,0
17937,application_1506638472019_8278,1,17377,17377,17937,560,560,66,0,0,0
17947,application_1506638472019_8479,1,17410,17410,17947,537,537,53,0,0,0
17947,application_1506638472019_9410,1,17623,17623,17947,324,324,49,0,0,0
17947,application_1506638472019_9190,1,17594,17594,17947,353,353,41,0,0,0
17947,application_1506638472019_8169,1,17296,17296,17947,651,651,70,0,0,0
17957,application_1506638472019_8398,1,17399,17399,17957,558,558,51,0,0,0
17964,application_1506638472019_8507,1,17414,17414,17964,550,550,45,0,0,0
17964,application_1506638472019_9302,1,17608,17608,17964,356,356,58,0,0,0
17984,application_1506638472019_9265,1,17603,17603,17984,381,381,54,0,0,0
17984,application_1506638472019_8516,1,17415,17415,17984,569,569,46,0,0,0
17984,application_1506638472019_8461,1,17407,17407,17984,577,577,50,0,0,0
17994,application_1506638472019_9316,1,17610,17610,17994,384,384,64,0,0,0
17994,application_1506638472019_8569,1,17422,17422,17994,572,572,57,0,0,0
17994,application_1506638472019_9169,1,17592,17592,17994,402,402,46,0,0,0
18004,application_1506638472019_9393,1,17621,17621,18004,383,383,49,0,0,0
18016,application_1506638472019_9746,1,17674,17674,18016,342,342,61,0,0,0
18036,application_1506638472019_8426,1,17402,17402,18036,634,634,49,0,0,0
18036,application_1506638472019_9563,1,17645,17645,18036,391,391,63,0,0,0
18036,application_1506638472019_9754,1,17680,17680,18036,356,356,60,0,0,0
18036,application_1506638472019_9384,1,17620,17620,18036,416,416,60,0,0,0
18046,application_1506638472019_9528,1,17638,17638,18046,408,408,54,0,0,0
18046,application_1506638472019_8693,1,17437,17437,18046,609,609,60,0,0,0
18046,application_1506638472019_9456,1,17629,17629,18046,417,417,58,0,0,0
18056,application_1506638472019_8614,1,17427,17427,18056,629,629,52,0,0,0
18056,application_1506638472019_9414,1,17624,17624,18056,432,432,56,0,0,0
18066,application_1506638472019_9562,1,17645,17645,18066,421,421,57,0,0,0
18066,application_1506638472019_9472,1,17631,17631,18066,435,435,56,0,0,0
18066,application_1506638472019_9450,1,17628,17628,18066,438,438,35,0,0,0
18076,application_1506638472019_9692,1,17665,17665,18076,411,411,57,0,0,0
18076,application_1506638472019_9735,1,17670,17670,18076,406,406,47,0,0,0
18096,application_1506638472019_9681,1,17663,17663,18096,433,433,53,0,0,0
18096,application_1506638472019_8287,1,17380,17380,18096,716,716,65,0,0,0
18096,application_1506638472019_9364,1,17617,17617,18096,479,479,42,0,0,0
18096,application_1506638472019_9329,1,17612,17612,18096,484,484,60,0,0,0
18096,application_1506638472019_8632,1,17430,17430,18096,666,666,56,0,0,0
18106,application_1506638472019_9349,1,17614,17614,18106,492,492,60,0,0,0
18106,application_1506638472019_8378,1,17395,17395,18106,711,711,45,0,0,0
18106,application_1506638472019_9629,1,17655,17655,18106,451,451,59,0,0,0
18106,application_1506638472019_9980,1,17840,17840,18106,266,266,56,0,0,0
18123,application_1506638472019_6688,1,17108,17108,18123,1015,1015,124,0,0,0
18133,application_1506638472019_6133,1,16685,16685,18133,1448,1448,177,0,0,0
18143,application_1506638472019_9638,1,17656,17656,18143,487,487,49,0,0,0
18153,application_1506638472019_9338,1,17613,17613,18153,540,540,58,0,0,0
18163,application_1506638472019_9220,1,17598,17598,18163,565,565,51,0,0,0
18163,application_1506638472019_8506,1,17414,17414,18163,749,749,49,0,0,0
18173,application_1506638472019_9734,1,17670,17670,18173,503,503,59,0,0,0
18173,application_1506638472019_8636,1,17430,17430,18173,743,743,60,0,0,0
18173,application_1506638472019_9985,1,17840,17840,18173,333,333,57,0,0,0
18173,application_1506638472019_9591,1,17650,17650,18173,523,523,56,0,0,0
18173,application_1506638472019_9668,1,17661,17661,18173,512,512,54,0,0,0
18173,application_1506638472019_8608,1,17426,17426,18173,747,747,61,0,0,0
18189,application_1506638472019_8557,1,17420,17420,18189,769,769,43,0,0,0
18189,application_1506638472019_9495,1,17634,17634,18189,555,555,47,0,0,0
18189,application_1506638472019_9362,1,17617,17617,18189,572,572,52,0,0,0
18199,application_1506638472019_9990,1,17841,17841,18199,358,358,50,0,0,0
18209,application_1506638472019_9444,1,17627,17627,18209,582,582,60,0,0,0
18226,application_1506638472019_9256,1,17602,17602,18226,624,624,48,0,0,0
18226,application_1506638472019_9659,1,17659,17659,18226,567,567,56,0,0,0
18246,application_1506638472019_9737,1,17671,17671,18246,575,575,61,0,0,0
18246,application_1506638472019_9297,1,17607,17607,18246,639,639,55,0,0,0
18246,application_1506638472019_9295,1,17607,17607,18246,639,639,56,0,0,0
18256,application_1506638472019_6277,1,17016,17016,18256,1240,1240,103,0,0,0
18258,application_1506638472019_9615,1,17653,17653,18258,605,605,50,0,0,0
18276,application_1506638472019_9745,1,17673,17673,18276,603,603,56,0,0,0
18276,application_1506638472019_10069,1,17855,17855,18276,421,421,56,0,0,0
18276,application_1506638472019_10038,1,17848,17848,18276,428,428,57,0,0,0
18299,application_1506638472019_9553,1,17643,17643,18299,656,656,61,0,0,0
18299,application_1506638472019_9263,1,17603,17603,18299,696,696,43,0,0,0
18299,application_1506638472019_8627,1,17429,17429,18299,870,870,54,0,0,0
18309,application_1506638472019_9463,1,17630,17630,18309,679,679,60,0,0,0
18309,application_1506638472019_9430,1,17626,17626,18309,683,683,56,0,0,0
18328,application_1504131676014_24488,1,6808,6808,18328,11520,11520,5404,0,0,0
18338,application_1506638472019_9212,1,17597,17597,18338,741,741,78,0,0,0
18356,application_1506638472019_9326,1,17612,17612,18356,744,744,55,0,0,0
18356,application_1506638472019_9596,1,17650,17650,18356,706,706,56,0,0,0
18356,application_1506638472019_9811,1,17726,17726,18356,630,630,72,0,0,0
18365,application_1506638472019_9749,1,17676,17676,18365,689,689,69,0,0,0
18375,application_1506638472019_9211,1,17597,17597,18375,778,778,54,0,0,0
18375,application_1506638472019_9967,1,17838,17838,18375,537,537,46,0,0,0
18385,application_1506638472019_10060,1,17850,17850,18385,535,535,54,0,0,0
18395,application_1506638472019_9664,1,17660,17660,18395,735,735,57,0,0,0
18405,application_1506638472019_9287,1,17606,17606,18405,799,799,56,0,0,0
18405,application_1506638472019_9583,1,17648,17648,18405,757,757,59,0,0,0
18415,application_1506638472019_9944,1,17834,17834,18415,581,581,50,0,0,0
18425,application_1506638472019_9673,1,17661,17661,18425,764,764,55,0,0,0
18445,application_1506638472019_9614,1,17653,17653,18445,792,792,62,0,0,0
18445,application_1506638472019_9467,1,17630,17630,18445,815,815,53,0,0,0
18445,application_1506638472019_10016,1,17844,17844,18445,601,601,55,0,0,0
18466,application_1506638472019_9998,1,17842,17842,18466,624,624,57,0,0,0
18476,application_1506638472019_9437,1,17626,17626,18476,850,850,46,0,0,0
18506,application_1506638472019_9208,1,17597,17597,18506,909,909,50,0,0,0
18516,application_1506638472019_9824,1,17756,17756,18516,760,760,67,0,0,0
18526,application_1506638472019_9988,1,17840,17840,18526,686,686,42,0,0,0
18526,application_1506638472019_9733,1,17670,17670,18526,856,856,53,0,0,0
18526,application_1506638472019_10450,2,18506,18506,18526,20,20,13,0,0,0
18536,application_1506638472019_10024,1,17846,17846,18536,690,690,57,0,0,0
18569,application_1506638472019_3773,8,13889,13889,18569,4680,4680,1053,0,0,0
18579,application_1506638472019_10055,1,17850,17850,18579,729,729,59,0,0,0
18579,application_1506638472019_9977,1,17839,17839,18579,740,740,51,0,0,0
18601,application_1506638472019_10310,1,18276,18276,18601,325,325,67,0,0,0
18627,application_1506638472019_9979,1,17840,17840,18627,787,787,66,0,0,0
18700,application_1504131676014_25217,1,8342,8342,18700,10358,10358,4406,0,0,0
18747,application_1506638472019_5973,1,16218,16218,18747,2529,2529,314,0,0,0
18753,application_1506638472019_10006,1,17843,17843,18753,910,910,53,0,0,0
18781,application_1506638472019_9924,1,17831,17831,18781,950,950,136,0,0,0
18814,application_1506638472019_10212,1,18076,18076,18814,738,738,66,0,0,0
18845,application_1506638472019_12190,2,18828,18828,18845,17,17,15,0,0,0
18883,application_1506638472019_10377,1,18356,18356,18883,527,527,72,0,0,0
18883,application_1506638472019_10276,1,18216,18216,18883,667,667,70,0,0,0
18933,application_1506638472019_9909,1,17828,17828,18933,1105,1105,132,0,0,0
18946,application_1506638472019_10199,1,18006,18006,18946,940,940,91,0,0,0
18985,application_1506638472019_10608,1,18601,18601,18985,384,384,51,0,0,0
19096,application_1506638472019_11216,1,18692,18692,19096,404,404,71,0,0,0
19126,application_1506638472019_10426,1,18456,18456,19126,670,670,80,0,0,0
19156,application_1506638472019_12377,1,18870,18870,19156,286,286,30,0,0,0
19210,application_1506638472019_9928,1,17832,17832,19210,1378,1378,138,0,0,0
19230,application_1506638472019_11196,1,18685,18685,19230,545,545,75,0,0,0
19230,application_1506638472019_12631,2,19210,19210,19230,20,20,16,0,0,0
19276,application_1506638472019_9936,1,17833,17833,19276,1443,1443,140,0,0,0
19306,application_1506638472019_11295,1,18706,18706,19306,600,600,75,0,0,0
19346,application_1506638472019_11184,1,18684,18684,19346,662,662,70,0,0,0
19376,application_1506638472019_9888,1,17826,17826,19376,1550,1550,136,0,0,0
19406,application_1506638472019_9817,1,17743,17743,19406,1663,1663,131,0,0,0
19456,application_1506638472019_10460,1,18526,18526,19456,930,930,69,0,0,0
19466,application_1506638472019_12614,1,19186,19186,19466,280,280,62,0,0,0
19496,application_1506638472019_11302,1,18706,18706,19496,790,790,69,0,0,0
19553,application_1506638472019_11322,1,18710,18710,19553,843,843,70,0,0,0
19589,application_1506638472019_9908,1,17828,17828,19589,1761,1761,139,0,0,0
19589,application_1506638472019_11309,1,18708,18708,19589,881,881,99,0,0,0
19589,application_1506638472019_9916,1,17829,17829,19589,1760,1760,132,0,0,0
19599,application_1506638472019_11269,1,18702,18702,19599,897,897,74,0,0,0
19619,application_1506638472019_12441,1,18936,18936,19619,683,683,64,0,0,0
19629,application_1506638472019_11234,1,18696,18696,19629,933,933,79,0,0,0
19681,application_1506638472019_12486,1,19006,19006,19681,675,675,72,0,0,0
19681,application_1506638472019_12859,2,19671,19671,19681,10,10,10,0,0,0
19697,application_1506638472019_12585,1,19106,19106,19697,591,591,63,0,0,0
19738,application_1506638472019_11436,1,18723,18723,19738,1015,1015,100,0,0,0
19804,application_1506638472019_11281,1,18704,18704,19804,1100,1100,70,0,0,0
19814,application_1506638472019_11310,1,18708,18708,19814,1106,1106,86,0,0,0
19824,application_1506638472019_11266,1,18701,18701,19824,1123,1123,77,0,0,0
19824,application_1506638472019_12639,1,19236,19236,19824,588,588,63,0,0,0
19841,application_1506638472019_11285,1,18704,18704,19841,1137,1137,101,0,0,0
19841,application_1506638472019_12645,1,19276,19276,19841,565,565,68,0,0,0
19864,application_1506638472019_12463,1,18996,18996,19864,868,868,71,0,0,0
19900,application_1506638472019_11182,1,18684,18684,19900,1216,1216,80,0,0,0
19910,application_1506638472019_11304,1,18707,18707,19910,1203,1203,73,0,0,0
19922,application_1506638472019_9892,1,17826,17826,19922,2096,2096,134,0,0,0
19949,application_1506638472019_12660,1,19376,19376,19949,573,573,73,0,0,0
19949,application_1506638472019_12691,1,19536,19536,19949,413,413,68,0,0,0
20016,application_1506638472019_1891,1,10945,10945,20016,9071,9071,2546,0,0,0
20176,application_1506638472019_11441,1,18723,18723,20176,1453,1453,73,0,0,0
20196,application_1506638472019_12731,1,19564,19564,20196,632,632,45,0,0,0
20286,application_1506638472019_11252,1,18699,18699,20286,1587,1587,73,0,0,0
20306,application_1506638472019_12576,1,19046,19046,20306,1260,1260,75,0,0,0
20346,application_1506638472019_12362,1,18866,18866,20346,1480,1480,91,0,0,0
20396,application_1506638472019_11223,1,18694,18694,20396,1702,1702,69,0,0,0
20416,application_1506638472019_12653,1,19326,19326,20416,1090,1090,66,0,0,0
20426,application_1506638472019_12648,1,19296,19296,20426,1130,1130,69,0,0,0
20446,application_1506638472019_12924,1,19756,19756,20446,690,690,57,0,0,0
20456,application_1506638472019_12951,1,19776,19776,20456,680,680,71,0,0,0
20516,application_1506638472019_12671,1,19446,19446,20516,1070,1070,69,0,0,0
20537,application_1506638472019_10224,1,18106,18106,20537,2431,2431,176,0,0,0
20557,application_1506638472019_11177,1,18683,18683,20557,1874,1874,73,0,0,0
20600,application_1506638472019_14084,1,19961,19961,20600,639,639,27,0,0,0
20686,application_1506638472019_13204,1,19848,19848,20686,838,838,25,0,0,0
20686,application_1506638472019_13701,1,19896,19896,20686,790,790,59,0,0,0
20706,application_1506638472019_12923,1,19755,19755,20706,951,951,58,0,0,0
20826,application_1506638472019_14105,1,19996,19996,20826,830,830,68,0,0,0
20836,application_1506638472019_12655,1,19336,19336,20836,1500,1500,65,0,0,0
20876,application_1506638472019_10296,1,18258,18258,20876,2618,2618,213,0,0,0
20966,application_1506638472019_12913,1,19744,19744,20966,1222,1222,66,0,0,0
21003,application_1506638472019_14102,1,19986,19986,21003,1017,1017,59,0,0,0
21003,application_1506638472019_12964,1,19794,19794,21003,1209,1209,98,0,0,0
21043,application_1506638472019_14296,1,20506,20506,21043,537,537,70,0,0,0
21116,application_1506638472019_11206,1,18687,18687,21116,2429,2429,174,0,0,0
21164,application_1506638472019_12934,1,19760,19760,21164,1404,1404,113,0,0,0
21174,application_1506638472019_14343,1,20616,20616,21174,558,558,67,0,0,0
21256,application_1506638472019_14267,1,20366,20366,21256,890,890,54,0,0,0
21406,application_1506638472019_12866,1,19683,19683,21406,1723,1723,165,0,0,0
21480,application_1506638472019_12867,1,19683,19683,21480,1797,1797,160,0,0,0
21490,application_1506638472019_14289,1,20476,20476,21490,1014,1014,74,0,0,0
21496,application_1506638472019_12337,1,18862,18862,21496,2634,2634,310,0,0,0
21516,application_1506638472019_14607,2,21420,21420,21516,96,96,28,0,0,0
21546,application_1506638472019_14241,1,20316,20316,21546,1230,1230,69,0,0,0
21566,application_1506638472019_12892,8,19710,19710,21566,1856,1856,125,0,0,0
21576,application_1506638472019_14363,1,20726,20726,21576,850,850,60,0,0,0
21576,application_1506638472019_7098,1,17159,17159,21576,4417,4417,403,0,0,0
21586,application_1506638472019_14376,1,20826,20826,21586,760,760,63,0,0,0
21596,application_1506638472019_14372,1,20796,20796,21596,800,800,56,0,0,0
21751,application_1506638472019_14364,1,20736,20736,21751,1015,1015,58,0,0,0
21786,application_1506638472019_14406,1,20976,20976,21786,810,810,71,0,0,0
21866,application_1506638472019_10802,1,18645,18645,21866,3221,3221,320,0,0,0
21866,application_1506638472019_10890,1,18654,18654,21866,3212,3212,319,0,0,0
21876,application_1506638472019_14185,1,20126,20126,21876,1750,1750,61,0,0,0
21886,application_1506638472019_5881,8,16028,16028,21886,5858,5858,427,0,0,0
21896,application_1506638472019_14412,1,21003,21003,21896,893,893,83,0,0,0
21941,application_1506638472019_14565,1,21116,21116,21941,825,825,70,0,0,0
21941,application_1506638472019_14618,1,21496,21496,21941,445,445,58,0,0,0
21956,application_1506638472019_12874,1,19687,19687,21956,2269,2269,195,0,0,0
21998,application_1506638472019_14594,1,21316,21316,21998,682,682,58,0,0,0
22004,application_1506638472019_12313,1,18858,18858,22004,3146,3146,306,0,0,0
22076,application_1506638472019_14157,1,20048,20048,22076,2028,2028,220,0,0,0
22096,application_1506638472019_10766,1,18640,18640,22096,3456,3456,297,0,0,0
22106,application_1506638472019_12326,1,18860,18860,22106,3246,3246,333,0,0,0
22147,application_1506638472019_14409,1,20996,20996,22147,1151,1151,66,0,0,0
22147,application_1506638472019_12359,1,18865,18865,22147,3282,3282,326,0,0,0
22176,application_1506638472019_14628,1,21556,21556,22176,620,620,57,0,0,0
22280,application_1506638472019_10831,1,18648,18648,22280,3632,3632,312,0,0,0
22355,application_1506638472019_14879,1,21931,21931,22355,424,424,64,0,0,0
22385,application_1506638472019_14831,1,21776,21776,22385,609,609,65,0,0,0
22465,application_1506638472019_14580,1,21216,21216,22465,1249,1249,62,0,0,0
22569,application_1506638472019_15231,1,22056,22056,22569,513,513,57,0,0,0
22578,application_1506638472019_14561,1,21106,21106,22578,1472,1472,59,0,0,0
22668,application_1506638472019_14621,1,21526,21526,22668,1142,1142,74,0,0,0
22698,application_1506638472019_12355,1,18865,18865,22698,3833,3833,308,0,0,0
22972,application_1506638472019_14584,1,21236,21236,22972,1736,1736,67,0,0,0
22992,application_1506638472019_15444,1,22466,22466,22992,526,526,61,0,0,0
23160,application_1506638472019_12329,1,18861,18861,23160,4299,4299,309,0,0,0
23162,application_1506638472019_15248,1,22166,22166,23162,996,996,66,0,0,0
23216,application_1506638472019_14888,1,21946,21946,23216,1270,1270,73,0,0,0
23216,application_1506638472019_14633,1,21596,21596,23216,1620,1620,68,0,0,0
23245,application_1506638472019_14325,1,20570,20570,23245,2675,2675,164,0,0,0
23283,application_1506638472019_16031,1,22726,22726,23283,557,557,59,0,0,0
23410,application_1506638472019_16038,1,22786,22786,23410,624,624,64,0,0,0
23506,application_1506638472019_15704,1,22526,22526,23506,980,980,86,0,0,0
23546,application_1506638472019_12333,1,18862,18862,23546,4684,4684,312,0,0,0
23586,application_1506638472019_12402,1,18873,18873,23586,4713,4713,294,0,0,0
23660,application_1506638472019_16346,1,23126,23126,23660,534,534,30,0,0,0
23720,application_1506638472019_16611,1,23206,23206,23720,514,514,68,0,0,0
23720,application_1506638472019_15434,2,22375,22375,23720,1345,1345,19,0,0,0
23792,application_1506638472019_15242,1,22117,22117,23792,1675,1675,153,0,0,0
23840,application_1506638472019_12629,1,19207,19207,23840,4633,4633,338,0,0,0
23880,application_1506638472019_5886,8,16030,16030,23880,7850,7850,424,0,0,0
24016,application_1506638472019_16631,1,23256,23256,24016,760,760,69,0,0,0
24106,application_1506638472019_16445,1,23146,23146,24106,960,960,62,0,0,0
24193,application_1506638472019_17236,1,23410,23410,24193,783,783,81,0,0,0
24213,application_1506638472019_17396,1,23777,23777,24213,436,436,34,0,0,0
24217,application_1506638472019_17320,1,23536,23536,24217,681,681,70,0,0,0
24238,application_1506638472019_16094,1,22996,22996,24238,1242,1242,66,0,0,0
24320,application_1506638472019_17327,1,23546,23546,24320,774,774,74,0,0,0
24330,application_1506638472019_17379,1,23747,23747,24330,583,583,32,0,0,0
24340,application_1506638472019_17259,1,23436,23436,24340,904,904,63,0,0,0
24340,application_1506638472019_17252,1,23430,23430,24340,910,910,74,0,0,0
24413,application_1506638472019_1890,1,10942,10942,24413,13471,13471,2389,0,0,0
24456,application_1506638472019_12336,1,18862,18862,24456,5594,5594,366,0,0,0
24466,application_1506638472019_16923,1,23316,23316,24466,1150,1150,82,0,0,0
24494,application_1506638472019_16605,1,23188,23188,24494,1306,1306,107,0,0,0
24530,application_1506638472019_17416,1,23816,23816,24530,714,714,71,0,0,0
24571,application_1506638472019_17523,1,24076,24076,24571,495,495,71,0,0,0
24706,application_1504131676014_25219,1,8343,8343,24706,16363,16363,4156,0,0,0
24856,application_1506638472019_17495,1,24036,24036,24856,820,820,65,0,0,0
24902,application_1506638472019_17343,1,23576,23576,24902,1326,1326,73,0,0,0
24909,application_1506638472019_17490,1,24006,24006,24909,903,903,66,0,0,0
24965,application_1506638472019_17493,1,24026,24026,24965,939,939,68,0,0,0
24991,application_1506638472019_18354,1,24581,24581,24991,410,410,22,0,0,0
25036,application_1506638472019_13678,1,19895,19895,25036,5141,5141,544,0,0,0
25140,application_1506638472019_16630,1,23246,23246,25140,1894,1894,79,0,0,0
25140,application_1506638472019_17556,1,24136,24136,25140,1004,1004,74,0,0,0
25176,application_1506638472019_17457,1,23916,23916,25176,1260,1260,68,0,0,0
25296,application_1506638472019_13801,1,19901,19901,25296,5395,5395,546,0,0,0
25386,application_1506638472019_17499,1,24056,24056,25386,1330,1330,75,0,0,0
25396,application_1506638472019_18039,1,24516,24516,25396,880,880,64,0,0,0
25396,application_1506638472019_17709,1,24436,24436,25396,960,960,66,0,0,0
25423,application_1506638472019_18343,1,24576,24576,25423,847,847,70,0,0,0
25504,application_1506638472019_12774,1,19570,19570,25504,5934,5934,548,0,0,0
25514,application_1506638472019_18816,1,24726,24726,25514,788,788,64,0,0,0
25514,application_1506638472019_17700,1,24416,24416,25514,1098,1098,77,0,0,0
25551,application_1506638472019_18780,1,24656,24656,25551,895,895,62,0,0,0
25656,application_1506638472019_17467,1,23956,23956,25656,1700,1700,70,0,0,0
25656,application_1506638472019_12370,1,18867,18867,25656,6789,6789,648,0,0,0
25726,application_1506638472019_13936,1,19920,19920,25726,5806,5806,581,0,0,0
25726,application_1506638472019_19755,1,24976,24976,25726,750,750,66,0,0,0
25756,application_1506638472019_13029,1,19835,19835,25756,5921,5921,544,0,0,0
25796,application_1506638472019_13260,1,19859,19859,25796,5937,5937,552,0,0,0
25825,application_1506638472019_18831,1,24766,24766,25825,1059,1059,72,0,0,0
25835,application_1506638472019_18776,1,24646,24646,25835,1189,1189,63,0,0,0
25876,application_1506638472019_20095,1,25146,25146,25876,730,730,74,0,0,0
25891,application_1506638472019_18996,1,24806,24806,25891,1085,1085,63,0,0,0
25931,application_1506638472019_18798,1,24666,24666,25931,1265,1265,72,0,0,0
26026,application_1506638472019_13422,1,19869,19869,26026,6157,6157,556,0,0,0
26040,application_1506638472019_20261,1,25541,25541,26040,499,499,39,0,0,0
26060,application_1506638472019_17549,2,24116,24116,26060,1944,1944,12,0,0,0
26070,application_1506638472019_17569,1,24173,24173,26070,1897,1897,156,0,0,0
26092,application_1506638472019_17608,1,24276,24276,26092,1816,1816,73,0,0,0
26102,application_1506638472019_13222,1,19850,19850,26102,6252,6252,557,0,0,0
26134,application_1506638472019_19809,1,24986,24986,26134,1148,1148,69,0,0,0
26154,application_1506638472019_19942,1,25036,25036,26154,1118,1118,61,0,0,0
26173,application_1506638472019_13818,1,19903,19903,26173,6270,6270,581,0,0,0
26193,application_1506638472019_20986,1,26163,26163,26193,30,30,8,0,0,0
26216,application_1506638472019_19996,1,25086,25086,26216,1130,1130,77,0,0,0
26283,application_1506638472019_13886,1,19913,19913,26283,6370,6370,563,0,0,0
26353,application_1506638472019_20201,1,25476,25476,26353,877,877,62,0,0,0
26364,application_1506638472019_20153,1,25276,25276,26364,1088,1088,67,0,0,0
26366,application_1506638472019_13211,1,19849,19849,26366,6517,6517,537,0,0,0
26386,application_1506638472019_20732,1,26026,26026,26386,360,360,16,0,0,0
26406,application_1506638472019_20281,1,25566,25566,26406,840,840,66,0,0,0
26416,application_1506638472019_20371,1,25716,25716,26416,700,700,79,0,0,0
26426,application_1506638472019_13744,1,19898,19898,26426,6528,6528,560,0,0,0
26458,application_1506638472019_14059,1,19929,19929,26458,6529,6529,540,0,0,0
26478,application_1506638472019_13978,1,19922,19922,26478,6556,6556,570,0,0,0
26508,application_1506638472019_13396,1,19867,19867,26508,6641,6641,558,0,0,0
26529,application_1506638472019_18806,1,24686,24686,26529,1843,1843,71,0,0,0
26552,application_1506638472019_20330,1,25669,25669,26552,883,883,72,0,0,0
26578,application_1506638472019_13308,1,19861,19861,26578,6717,6717,531,0,0,0
26636,application_1506638472019_13722,1,19897,19897,26636,6739,6739,559,0,0,0
26636,application_1506638472019_13641,1,19893,19893,26636,6743,6743,536,0,0,0
26666,application_1506638472019_13480,1,19871,19871,26666,6795,6795,543,0,0,0
26676,application_1506638472019_13954,1,19921,19921,26676,6755,6755,547,0,0,0
26676,application_1506638472019_20400,1,25776,25776,26676,900,900,66,0,0,0
26696,application_1506638472019_13103,1,19840,19840,26696,6856,6856,581,0,0,0
26726,application_1506638472019_13629,1,19891,19891,26726,6835,6835,594,0,0,0
26776,application_1506638472019_13532,1,19875,19875,26776,6901,6901,538,0,0,0
26804,application_1506638472019_13371,1,19866,19866,26804,6938,6938,561,0,0,0
26804,application_1506638472019_13761,1,19899,19899,26804,6905,6905,530,0,0,0
26834,application_1506638472019_13784,1,19900,19900,26834,6934,6934,532,0,0,0
26869,application_1506638472019_20332,1,25671,25671,26869,1198,1198,58,0,0,0
26889,application_1506638472019_13144,1,19843,19843,26889,7046,7046,526,0,0,0
26899,application_1506638472019_20438,1,25846,25846,26899,1053,1053,67,0,0,0
26899,application_1506638472019_20169,1,25376,25376,26899,1523,1523,73,0,0,0
26919,application_1506638472019_13655,1,19894,19894,26919,7025,7025,547,0,0,0
26919,application_1506638472019_13514,1,19874,19874,26919,7045,7045,568,0,0,0
26960,application_1506638472019_13481,1,19871,19871,26960,7089,7089,562,0,0,0
26960,application_1506638472019_14029,1,19927,19927,26960,7033,7033,536,0,0,0
26980,application_1506638472019_13478,1,19871,19871,26980,7109,7109,599,0,0,0
27040,application_1506638472019_20316,1,25646,25646,27040,1394,1394,71,0,0,0
27060,application_1506638472019_13627,1,19891,19891,27060,7169,7169,528,0,0,0
27071,application_1506638472019_13538,1,19876,19876,27071,7195,7195,531,0,0,0
27081,application_1506638472019_13568,1,19881,19881,27081,7200,7200,539,0,0,0
27081,application_1506638472019_20710,1,25986,25986,27081,1095,1095,59,0,0,0
27087,application_1506638472019_13417,1,19868,19868,27087,7219,7219,555,0,0,0
27095,application_1506638472019_13710,1,19897,19897,27095,7198,7198,513,0,0,0
27125,application_1506638472019_13167,1,19845,19845,27125,7280,7280,531,0,0,0
27125,application_1506638472019_13477,1,19871,19871,27125,7254,7254,551,0,0,0
27160,application_1506638472019_13581,1,19886,19886,27160,7274,7274,582,0,0,0
27160,application_1506638472019_13525,1,19875,19875,27160,7285,7285,544,0,0,0
27193,application_1506638472019_18817,2,24727,24727,27193,2466,2466,12,0,0,0
27200,application_1506638472019_18825,2,24747,24747,27200,2453,2453,18,0,0,0
27225,application_1506638472019_13345,1,19864,19864,27225,7361,7361,537,0,0,0
27240,application_1506638472019_13865,1,19910,19910,27240,7330,7330,552,0,0,0
27240,application_1506638472019_20764,1,26106,26106,27240,1134,1134,58,0,0,0
27294,application_1506638472019_16624,1,23245,23245,27294,4049,4049,207,0,0,0
27294,application_1506638472019_14016,1,19926,19926,27294,7368,7368,555,0,0,0
27294,application_1506638472019_22430,1,26566,26566,27294,728,728,69,0,0,0
27304,application_1506638472019_13063,1,19837,19837,27304,7467,7467,590,0,0,0
27304,application_1506638472019_13939,1,19920,19920,27304,7384,7384,543,0,0,0
27344,application_1506638472019_13877,1,19912,19912,27344,7432,7432,569,0,0,0
27347,application_1506638472019_17582,1,24217,24217,27347,3130,3130,168,0,0,0
27367,application_1506638472019_10540,1,18556,18556,27367,8811,8811,698,0,0,0
27371,application_1506638472019_13348,1,19864,19864,27371,7507,7507,560,0,0,0
27384,application_1506638472019_2613,1,13287,13287,27384,14097,14097,2104,0,0,0
27411,application_1506638472019_13344,1,19864,19864,27411,7547,7547,573,0,0,0
27426,application_1506638472019_11388,1,18718,18718,27426,8708,8708,665,0,0,0
27442,application_1506638472019_13355,1,19865,19865,27442,7577,7577,553,0,0,0
27472,application_1506638472019_13025,1,19835,19835,27472,7637,7637,562,0,0,0
27472,application_1506638472019_20430,1,25836,25836,27472,1636,1636,67,0,0,0
27472,application_1506638472019_13251,1,19858,19858,27472,7614,7614,538,0,0,0
27482,application_1506638472019_20331,1,25671,25671,27482,1811,1811,103,0,0,0
27502,application_1506638472019_12764,1,19569,19569,27502,7933,7933,553,0,0,0
27502,application_1506638472019_13426,1,19869,19869,27502,7633,7633,628,0,0,0
27512,application_1506638472019_13171,1,19845,19845,27512,7667,7667,553,0,0,0
27522,application_1506638472019_13983,1,19922,19922,27522,7600,7600,544,0,0,0
27532,application_1506638472019_13972,1,19922,19922,27532,7610,7610,545,0,0,0
27542,application_1506638472019_13365,1,19865,19865,27542,7677,7677,593,0,0,0
27562,application_1506638472019_22537,1,26856,26856,27562,706,706,71,0,0,0
27582,application_1506638472019_13483,1,19872,19872,27582,7710,7710,521,0,0,0
27582,application_1506638472019_13964,1,19921,19921,27582,7661,7661,555,0,0,0
27582,application_1506638472019_13320,1,19862,19862,27582,7720,7720,566,0,0,0
27582,application_1506638472019_13960,1,19921,19921,27582,7661,7661,560,0,0,0
27627,application_1506638472019_11490,1,18729,18729,27627,8898,8898,674,0,0,0
27637,application_1506638472019_13786,1,19900,19900,27637,7737,7737,558,0,0,0
27647,application_1506638472019_12997,1,19832,19832,27647,7815,7815,529,0,0,0
27647,application_1506638472019_11506,1,18730,18730,27647,8917,8917,682,0,0,0
27703,application_1506638472019_20719,1,26006,26006,27703,1697,1697,64,0,0,0
27712,application_1506638472019_12736,1,19565,19565,27712,8147,8147,552,0,0,0
27720,application_1506638472019_22476,1,26636,26636,27720,1084,1084,66,0,0,0
27732,application_1506638472019_13802,1,19902,19902,27732,7830,7830,563,0,0,0
27736,application_1506638472019_20294,2,25595,25595,27736,2141,2141,15,0,0,0
27753,application_1506638472019_12244,1,18849,18849,27753,8904,8904,650,0,0,0
27758,application_1506638472019_13675,1,19895,19895,27758,7863,7863,591,0,0,0
27790,application_1506638472019_13593,1,19887,19887,27790,7903,7903,538,0,0,0
27790,application_1506638472019_13389,1,19867,19867,27790,7923,7923,708,0,0,0
27790,application_1506638472019_13757,1,19899,19899,27790,7891,7891,563,0,0,0
27798,application_1506638472019_13603,1,19888,19888,27798,7910,7910,531,0,0,0
27806,application_1506638472019_13180,1,19846,19846,27806,7960,7960,565,0,0,0
27806,application_1506638472019_13039,1,19836,19836,27806,7970,7970,548,0,0,0
27806,application_1506638472019_13819,1,19903,19903,27806,7903,7903,536,0,0,0
27806,application_1506638472019_13703,1,19896,19896,27806,7910,7910,534,0,0,0
27811,application_1506638472019_13449,1,19870,19870,27811,7941,7941,547,0,0,0
27821,application_1506638472019_13828,1,19905,19905,27821,7916,7916,559,0,0,0
27830,application_1506638472019_13012,1,19834,19834,27830,7996,7996,534,0,0,0
27841,application_1506638472019_11495,1,18729,18729,27841,9112,9112,668,0,0,0
27874,application_1506638472019_20138,1,25228,25228,27874,2646,2646,149,0,0,0
27893,application_1506638472019_13119,1,19841,19841,27893,8052,8052,597,0,0,0
27893,application_1506638472019_13952,1,19921,19921,27893,7972,7972,534,0,0,0
27902,application_1506638472019_13919,1,19919,19919,27902,7983,7983,541,0,0,0
28002,application_1506638472019_12811,1,19575,19575,28002,8427,8427,538,0,0,0
28025,application_1506638472019_14146,1,20035,20035,28025,7990,7990,572,0,0,0
28034,application_1506638472019_21913,2,26342,26342,28034,1692,1692,14,0,0,0
28065,application_1506638472019_13410,1,19868,19868,28065,8197,8197,563,0,0,0
28075,application_1506638472019_22351,1,26556,26556,28075,1519,1519,69,0,0,0
28107,application_1506638472019_12773,1,19570,19570,28107,8537,8537,561,0,0,0
28117,application_1506638472019_13970,1,19922,19922,28117,8195,8195,555,0,0,0
28167,application_1506638472019_10536,1,18555,18555,28167,9612,9612,693,0,0,0
28207,application_1506638472019_11658,1,18753,18753,28207,9454,9454,636,0,0,0
28227,application_1506638472019_13254,1,19858,19858,28227,8369,8369,549,0,0,0
28287,application_1506638472019_14027,1,19927,19927,28287,8360,8360,538,0,0,0
28297,application_1506638472019_11519,1,18732,18732,28297,9565,9565,686,0,0,0
28307,application_1506638472019_13044,1,19836,19836,28307,8471,8471,562,0,0,0
28317,application_1506638472019_13338,1,19863,19863,28317,8454,8454,557,0,0,0
28317,application_1506638472019_22472,1,26596,26596,28317,1721,1721,64,0,0,0
28322,application_1506638472019_13245,1,19858,19858,28322,8464,8464,588,0,0,0
28336,application_1506638472019_22512,1,26796,26796,28336,1540,1540,61,0,0,0
28336,application_1506638472019_13962,1,19921,19921,28336,8415,8415,553,0,0,0
28349,application_1506638472019_13036,1,19836,19836,28349,8513,8513,541,0,0,0
28351,application_1506638472019_22491,1,26706,26706,28351,1645,1645,64,0,0,0
28402,application_1506638472019_12802,1,19573,19573,28402,8829,8829,560,0,0,0
28437,application_1506638472019_13055,1,19837,19837,28437,8600,8600,543,0,0,0
28437,application_1506638472019_13778,1,19900,19900,28437,8537,8537,584,0,0,0
28437,application_1506638472019_11622,1,18747,18747,28437,9690,9690,654,0,0,0
28437,application_1506638472019_13225,1,19851,19851,28437,8586,8586,563,0,0,0
28443,application_1506638472019_11521,1,18732,18732,28443,9711,9711,707,0,0,0
28443,application_1504131676014_20508,1,3152,3152,28443,25291,25291,8590,0,0,0
28473,application_1506638472019_14018,1,19926,19926,28473,8547,8547,559,0,0,0
28483,application_1506638472019_12801,1,19573,19573,28483,8910,8910,570,0,0,0
28513,application_1506638472019_13496,1,19872,19872,28513,8641,8641,545,0,0,0
28543,application_1506638472019_13805,1,19902,19902,28543,8641,8641,593,0,0,0
28571,application_1506638472019_13998,1,19923,19923,28571,8648,8648,540,0,0,0
28603,application_1506638472019_23190,1,27166,27166,28603,1437,1437,65,0,0,0
28603,application_1506638472019_13966,1,19921,19921,28603,8682,8682,602,0,0,0
28603,application_1506638472019_13699,1,19896,19896,28603,8707,8707,588,0,0,0
28623,application_1506638472019_23086,1,27126,27126,28623,1497,1497,84,0,0,0
28633,application_1506638472019_13557,1,19880,19880,28633,8753,8753,534,0,0,0
28643,application_1506638472019_13187,1,19846,19846,28643,8797,8797,547,0,0,0
28658,application_1506638472019_10571,1,18559,18559,28658,10099,10099,795,0,0,0
28765,application_1506638472019_13934,1,19920,19920,28765,8845,8845,553,0,0,0
28782,application_1506638472019_13075,1,19838,19838,28782,8944,8944,576,0,0,0
28804,application_1504131676014_16894,16,1065,1065,28804,27739,27739,21676,0,0,0
28841,application_1506638472019_13454,1,19870,19870,28841,8971,8971,556,0,0,0
28934,application_1506638472019_13101,1,19840,19840,28934,9094,9094,549,0,0,0
28948,application_1506638472019_13558,1,19880,19880,28948,9068,9068,560,0,0,0
28958,application_1506638472019_13815,1,19903,19903,28958,9055,9055,578,0,0,0
28996,application_1506638472019_13635,1,19892,19892,28996,9104,9104,554,0,0,0
29006,application_1506638472019_11473,1,18727,18727,29006,10279,10279,671,0,0,0
29006,application_1506638472019_13492,1,19872,19872,29006,9134,9134,568,0,0,0
29006,application_1506638472019_24290,1,27386,27386,29006,1620,1620,60,0,0,0
29016,application_1506638472019_13765,1,19899,19899,29016,9117,9117,577,0,0,0
29063,application_1506638472019_12292,1,18855,18855,29063,10208,10208,856,0,0,0
29078,application_1506638472019_13148,1,19844,19844,29078,9234,9234,566,0,0,0
29184,application_1506638472019_26948,1,28652,28652,29184,532,532,33,0,0,0
29211,application_1506638472019_13760,1,19899,19899,29211,9312,9312,557,0,0,0
29276,application_1506638472019_27653,1,28844,28844,29276,432,432,30,0,0,0
29310,application_1506638472019_11432,1,18722,18722,29310,10588,10588,694,0,0,0
29353,application_1506638472019_13428,1,19869,19869,29353,9484,9484,532,0,0,0
29373,application_1506638472019_13164,1,19845,19845,29373,9528,9528,558,0,0,0
29383,application_1506638472019_13955,1,19921,19921,29383,9462,9462,560,0,0,0
29393,application_1506638472019_24358,1,27416,27416,29393,1977,1977,64,0,0,0
29416,application_1506638472019_13086,1,19839,19839,29416,9577,9577,596,0,0,0
29596,application_1506638472019_13803,1,19902,19902,29596,9694,9694,607,0,0,0
29596,application_1506638472019_23858,1,27294,27294,29596,2302,2302,78,0,0,0
29626,application_1506638472019_13822,1,19904,19904,29626,9722,9722,553,0,0,0
29636,application_1506638472019_13885,1,19913,19913,29636,9723,9723,556,0,0,0
29666,application_1506638472019_13945,1,19920,19920,29666,9746,9746,548,0,0,0
29726,application_1506638472019_13973,1,19922,19922,29726,9804,9804,545,0,0,0
29726,application_1506638472019_13510,1,19873,19873,29726,9853,9853,565,0,0,0
29746,application_1506638472019_13347,1,19864,19864,29746,9882,9882,566,0,0,0
29896,application_1506638472019_27776,1,28996,28996,29896,900,900,68,0,0,0
29926,application_1506638472019_13358,1,19865,19865,29926,10061,10061,560,0,0,0
30000,application_1506638472019_13749,1,19898,19898,30000,10102,10102,551,0,0,0
30020,application_1506638472019_26530,1,28548,28548,30020,1472,1472,72,0,0,0
30067,application_1506638472019_27693,1,28906,28906,30067,1161,1161,64,0,0,0
30075,application_1506638472019_28483,1,29171,29171,30075,904,904,56,0,0,0
30075,application_1506638472019_6181,1,16794,16794,30075,13281,13281,939,0,0,0
30075,application_1506638472019_13067,1,19837,19837,30075,10238,10238,579,0,0,0
30109,application_1506638472019_13065,1,19837,19837,30109,10272,10272,551,0,0,0
30126,application_1506638472019_11479,1,18728,18728,30126,11398,11398,699,0,0,0
30180,application_1506638472019_27019,1,28686,28686,30180,1494,1494,68,0,0,0
30180,application_1506638472019_12207,1,18832,18832,30180,11348,11348,677,0,0,0
30186,application_1506638472019_13412,1,19868,19868,30186,10318,10318,580,0,0,0
30206,application_1506638472019_13398,1,19867,19867,30206,10339,10339,549,0,0,0
30223,application_1506638472019_25175,2,27796,27796,30223,2427,2427,39,0,0,0
30252,application_1506638472019_23064,1,27105,27105,30252,3147,3147,190,0,0,0
30272,application_1506638472019_27609,1,28776,28776,30272,1496,1496,66,0,0,0
30286,application_1506638472019_28724,1,29216,29216,30286,1070,1070,59,0,0,0
30286,application_1506638472019_17330,4,23547,23547,30286,6739,6739,103,0,0,0
30318,application_1506638472019_13490,1,19872,19872,30318,10446,10446,571,0,0,0
30326,application_1506638472019_29184,1,29800,29800,30326,526,526,25,0,0,0
30336,application_1506638472019_13091,1,19839,19839,30336,10497,10497,545,0,0,0
30466,application_1506638472019_23053,1,27095,27095,30466,3371,3371,270,0,0,0
30506,application_1506638472019_27697,1,28916,28916,30506,1590,1590,66,0,0,0
30575,application_1506638472019_29127,1,29706,29706,30575,869,869,75,0,0,0
30585,application_1506638472019_13287,1,19860,19860,30585,10725,10725,564,0,0,0
30585,application_1506638472019_13942,1,19920,19920,30585,10665,10665,537,0,0,0
30667,application_1506638472019_29048,1,29396,29396,30667,1271,1271,77,0,0,0
30816,application_1506638472019_29725,1,30186,30186,30816,630,630,68,0,0,0
30836,application_1506638472019_29275,1,29826,29826,30836,1010,1010,70,0,0,0
30846,application_1506638472019_29074,1,29486,29486,30846,1360,1360,74,0,0,0
30856,application_1506638472019_12716,1,19562,19562,30856,11294,11294,832,0,0,0
30866,application_1506638472019_13800,1,19901,19901,30866,10965,10965,528,0,0,0
30876,application_1506638472019_13587,1,19887,19887,30876,10989,10989,686,0,0,0
30886,application_1506638472019_13573,1,19881,19881,30886,11005,11005,677,0,0,0
30931,application_1506638472019_29099,1,29576,29576,30931,1355,1355,67,0,0,0
30936,application_1506638472019_28817,1,29266,29266,30936,1670,1670,68,0,0,0
30938,application_1506638472019_14026,1,19927,19927,30938,11011,11011,598,0,0,0
30948,application_1506638472019_29760,1,30286,30286,30948,662,662,64,0,0,0
30991,application_1506638472019_13716,1,19897,19897,30991,11094,11094,595,0,0,0
31192,application_1506638472019_29709,1,30136,30136,31192,1056,1056,54,0,0,0
31238,application_1506638472019_11375,1,18716,18716,31238,12522,12522,723,0,0,0
31268,application_1506638472019_11405,1,18719,18719,31268,12549,12549,708,0,0,0
31326,application_1506638472019_28470,1,29166,29166,31326,2160,2160,65,0,0,0
31426,application_1506638472019_29116,1,29656,29656,31426,1770,1770,86,0,0,0
31437,application_1506638472019_26209,1,28070,28070,31437,3367,3367,146,0,0,0
31531,application_1506638472019_29330,1,29916,29916,31531,1615,1615,64,0,0,0
31641,application_1506638472019_29977,1,30716,30716,31641,925,925,64,0,0,0
31661,application_1506638472019_12539,1,19012,19012,31661,12649,12649,906,0,0,0
31671,application_1506638472019_13400,1,19867,19867,31671,11804,11804,714,0,0,0
31714,application_1506638472019_12726,1,19564,19564,31714,12150,12150,829,0,0,0
31734,application_1506638472019_29717,1,30156,30156,31734,1578,1578,61,0,0,0
31734,application_1506638472019_22815,1,26994,26994,31734,4740,4740,216,0,0,0
31749,application_1506638472019_29107,1,29606,29606,31749,2143,2143,66,0,0,0
31769,application_1506638472019_12541,1,19012,19012,31769,12757,12757,924,0,0,0
31796,application_1506638472019_29783,1,30336,30336,31796,1460,1460,69,0,0,0
31816,application_1506638472019_20954,1,26117,26117,31816,5699,5699,354,0,0,0
31846,application_1506638472019_29710,1,30146,30146,31846,1700,1700,62,0,0,0
31856,application_1506638472019_29346,1,29956,29956,31856,1900,1900,74,0,0,0
31922,application_1506638472019_29002,1,29325,29325,31922,2597,2597,69,0,0,0
31965,application_1506638472019_29102,1,29600,29600,31965,2365,2365,65,0,0,0
31996,application_1506638472019_24366,1,27442,27442,31996,4554,4554,168,0,0,0
32027,application_1506638472019_12816,1,19576,19576,32027,12451,12451,822,0,0,0
32113,application_1506638472019_29850,1,30586,30586,32113,1527,1527,62,0,0,0
32123,application_1506638472019_24865,1,27758,27758,32123,4365,4365,244,0,0,0
32143,application_1506638472019_3256,1,13380,13380,32143,18763,18763,2475,0,0,0
32163,application_1506638472019_29394,1,30026,30026,32163,2137,2137,61,0,0,0
32246,application_1506638472019_29080,1,29496,29496,32246,2750,2750,70,0,0,0
32256,application_1506638472019_29296,1,29856,29856,32256,2400,2400,70,0,0,0
32266,application_1506638472019_20418,1,25815,25815,32266,6451,6451,394,0,0,0
32286,application_1506638472019_12824,1,19579,19579,32286,12707,12707,872,0,0,0
32296,application_1506638472019_29802,1,30406,30406,32296,1890,1890,57,0,0,0
32296,application_1506638472019_2680,1,13301,13301,32296,18995,18995,2410,0,0,0
32326,application_1506638472019_9843,1,17822,17822,32326,14504,14504,976,0,0,0
32346,application_1506638472019_29990,1,30776,30776,32346,1570,1570,61,0,0,0
32356,application_1506638472019_22783,1,26991,26991,32356,5365,5365,310,0,0,0
32376,application_1506638472019_3847,8,14036,14036,32376,18340,18340,1881,0,0,0
32406,application_1506638472019_31240,1,31276,31276,32406,1130,1130,56,0,0,0
32436,application_1506638472019_14487,1,21072,21072,32436,11364,11364,869,0,0,0
32436,application_1506638472019_29235,1,29816,29816,32436,2620,2620,61,0,0,0
32466,application_1506638472019_31667,1,31786,31786,32466,680,680,75,0,0,0
32486,application_1506638472019_31264,1,31376,31376,32486,1110,1110,66,0,0,0
32516,application_1506638472019_29359,1,29967,29967,32516,2549,2549,134,0,0,0
32536,application_1506638472019_29776,1,30326,30326,32536,2210,2210,68,0,0,0
32636,application_1506638472019_10265,1,18179,18179,32636,14457,14457,930,0,0,0
32636,application_1506638472019_12512,1,19009,19009,32636,13627,13627,944,0,0,0
32656,application_1506638472019_29693,1,30116,30116,32656,2540,2540,65,0,0,0
32669,application_1506638472019_11439,1,18723,18723,32669,13946,13946,667,0,0,0
32709,application_1506638472019_31241,1,31286,31286,32709,1423,1423,87,0,0,0
32796,application_1506638472019_31527,1,31606,31606,32796,1190,1190,61,0,0,0
32816,application_1506638472019_28611,1,29199,29199,32816,3617,3617,142,0,0,0
32996,application_1506638472019_26891,1,28643,28643,32996,4353,4353,150,0,0,0
33116,application_1506638472019_12563,1,19014,19014,33116,14102,14102,911,0,0,0
33146,application_1506638472019_10126,1,17910,17910,33146,15236,15236,1167,0,0,0
33250,application_1506638472019_14557,1,21097,21097,33250,12153,12153,854,0,0,0
33269,application_1506638472019_31074,1,31156,31156,33269,2113,2113,78,0,0,0
33274,application_1506638472019_27637,2,28812,28812,33274,4462,4462,32,0,0,0
33284,application_1506638472019_28191,2,29102,29102,33284,4182,4182,36,0,0,0
33286,application_1506638472019_28078,1,29081,29081,33286,4205,4205,262,0,0,0
33296,application_1506638472019_22770,1,26989,26989,33296,6307,6307,308,0,0,0
33296,application_1506638472019_28623,2,29201,29201,33296,4095,4095,19,0,0,0
33340,application_1506638472019_31776,1,31996,31996,33340,1344,1344,68,0,0,0
33396,application_1506638472019_29842,1,30575,30575,33396,2821,2821,88,0,0,0
33556,application_1506638472019_31587,1,31616,31616,33556,1940,1940,68,0,0,0
33586,application_1506638472019_28044,1,29077,29077,33586,4509,4509,239,0,0,0
33916,application_1506638472019_31923,1,32536,32536,33916,1380,1380,67,0,0,0
33966,application_1506638472019_22928,1,27006,27006,33966,6960,6960,319,0,0,0
33996,application_1506638472019_32688,1,33421,33421,33996,575,575,11,0,0,0
34006,application_1506638472019_31918,1,32516,32516,34006,1490,1490,78,0,0,0
34036,application_1506638472019_9850,1,17823,17823,34036,16213,16213,1062,0,0,0
34112,application_1506638472019_32051,1,32896,32896,34112,1216,1216,71,0,0,0
34226,application_1506638472019_12815,1,19576,19576,34226,14650,14650,741,0,0,0
34264,application_1506638472019_31930,1,32576,32576,34264,1688,1688,61,0,0,0
34278,application_1506638472019_31036,2,31106,31106,34278,3172,3172,14,0,0,0
34282,application_1506638472019_31031,2,31082,31082,34282,3200,3200,21,0,0,0
34330,application_1506638472019_31892,1,32406,32406,34330,1924,1924,76,0,0,0
34379,application_1506638472019_32819,1,33466,33466,34379,913,913,64,0,0,0
34379,application_1506638472019_32036,1,32876,32876,34379,1503,1503,68,0,0,0
34393,application_1506638472019_31902,1,32436,32436,34393,1957,1957,81,0,0,0
34442,application_1506638472019_32071,1,32966,32966,34442,1476,1476,62,0,0,0
34442,application_1506638472019_31954,1,32636,32636,34442,1806,1806,67,0,0,0
34462,application_1506638472019_29722,1,30180,30180,34462,4282,4282,176,0,0,0
34510,application_1506638472019_32622,1,33366,33366,34510,1144,1144,56,0,0,0
34536,application_1506638472019_22888,1,27001,27001,34536,7535,7535,314,0,0,0
34546,application_1506638472019_32095,1,33046,33046,34546,1500,1500,61,0,0,0
34566,application_1506638472019_32076,1,32996,32996,34566,1570,1570,70,0,0,0
34650,application_1506638472019_26461,1,28427,28427,34650,6223,6223,233,0,0,0
34716,application_1506638472019_11662,1,18753,18753,34716,15963,15963,969,0,0,0
34716,application_1506638472019_26479,1,28443,28443,34716,6273,6273,274,0,0,0
34746,application_1506638472019_9882,1,17825,17825,34746,16921,16921,985,0,0,0
34756,application_1506638472019_33278,1,34264,34264,34756,492,492,43,0,0,0
34778,application_1506638472019_31816,1,32033,32033,34778,2745,2745,49,0,0,0
34799,application_1506638472019_31859,1,32166,32166,34799,2633,2633,69,0,0,0
34809,application_1506638472019_32000,1,32766,32766,34809,2043,2043,70,0,0,0
34819,application_1506638472019_32982,1,33726,33726,34819,1093,1093,80,0,0,0
34829,application_1506638472019_22897,1,27003,27003,34829,7826,7826,313,0,0,0
34856,application_1506638472019_33561,1,34311,34311,34856,545,545,42,0,0,0
34891,application_1506638472019_33366,1,34279,34279,34891,612,612,44,0,0,0
34895,application_1506638472019_32075,1,32986,32986,34895,1909,1909,80,0,0,0
34929,application_1506638472019_31873,1,32256,32256,34929,2673,2673,78,0,0,0
34929,application_1506638472019_33276,1,34264,34264,34929,665,665,43,0,0,0
34932,application_1506638472019_32921,1,33636,33636,34932,1296,1296,69,0,0,0
34987,application_1506638472019_32919,1,33626,33626,34987,1361,1361,61,0,0,0
34987,application_1506638472019_33277,1,34264,34264,34987,723,723,49,0,0,0
34987,application_1506638472019_33299,1,34267,34267,34987,720,720,45,0,0,0
34987,application_1506638472019_26475,1,28443,28443,34987,6544,6544,243,0,0,0
34997,application_1506638472019_33395,1,34283,34283,34997,714,714,49,0,0,0
34997,application_1506638472019_33623,1,34322,34322,34997,675,675,42,0,0,0
34997,application_1506638472019_32910,1,33606,33606,34997,1391,1391,63,0,0,0
35007,application_1506638472019_33466,1,34295,34295,35007,712,712,47,0,0,0
35019,application_1506638472019_32682,1,33416,33416,35019,1603,1603,53,0,0,0
35086,application_1506638472019_33450,1,34292,34292,35086,794,794,38,0,0,0
35086,application_1506638472019_33598,1,34315,34315,35086,771,771,43,0,0,0
35113,application_1506638472019_33016,1,33816,33816,35113,1297,1297,55,0,0,0
35113,application_1506638472019_33659,1,34327,34327,35113,786,786,53,0,0,0
35147,application_1506638472019_32971,1,33715,33715,35147,1432,1432,65,0,0,0
35153,application_1506638472019_33539,1,34307,34307,35153,846,846,47,0,0,0
35164,application_1506638472019_28025,1,29076,29076,35164,6088,6088,251,0,0,0
35174,application_1506638472019_24881,1,27759,27759,35174,7415,7415,386,0,0,0
35184,application_1506638472019_33613,1,34319,34319,35184,865,865,44,0,0,0
35198,application_1506638472019_28061,1,29079,29079,35198,6119,6119,241,0,0,0
35207,application_1506638472019_31920,1,32526,32526,35207,2681,2681,67,0,0,0
35233,application_1506638472019_33389,1,34282,34282,35233,951,951,51,0,0,0
35234,application_1506638472019_33558,1,34310,34310,35234,924,924,49,0,0,0
35237,application_1506638472019_13231,1,19852,19852,35237,15385,15385,720,0,0,0
35237,application_1506638472019_31686,1,31826,31826,35237,3411,3411,76,0,0,0
35244,application_1506638472019_33421,1,34286,34286,35244,958,958,37,0,0,0
35266,application_1506638472019_33379,1,34280,34280,35266,986,986,45,0,0,0
35286,application_1506638472019_10141,1,17916,17916,35286,17370,17370,1201,0,0,0
35296,application_1506638472019_22860,1,26999,26999,35296,8297,8297,355,0,0,0
35306,application_1506638472019_14559,1,21100,21100,35306,14206,14206,890,0,0,0
35306,application_1506638472019_33255,1,34260,34260,35306,1046,1046,39,0,0,0
35316,application_1506638472019_33110,1,34066,34066,35316,1250,1250,61,0,0,0
35326,application_1506638472019_33473,1,34296,34296,35326,1030,1030,38,0,0,0
35326,application_1506638472019_33312,1,34270,34270,35326,1056,1056,54,0,0,0
35345,application_1506638472019_32319,1,33286,33286,35345,2059,2059,72,0,0,0
35357,application_1506638472019_32768,1,33436,33436,35357,1921,1921,68,0,0,0
35362,application_1506638472019_33724,1,34337,34337,35362,1025,1025,56,0,0,0
35362,application_1506638472019_33488,1,34298,34298,35362,1064,1064,42,0,0,0
35362,application_1506638472019_32099,1,33086,33086,35362,2276,2276,63,0,0,0
35367,application_1506638472019_33809,1,34352,34352,35367,1015,1015,40,0,0,0
35370,application_1506638472019_33733,1,34339,34339,35370,1031,1031,52,0,0,0
35372,application_1506638472019_22831,1,26995,26995,35372,8377,8377,315,0,0,0
35391,application_1506638472019_33549,1,34309,34309,35391,1082,1082,46,0,0,0
35401,application_1506638472019_33426,1,34287,34287,35401,1114,1114,49,0,0,0
35401,application_1506638472019_33648,1,34326,34326,35401,1075,1075,59,0,0,0
35411,application_1506638472019_33654,1,34327,34327,35411,1084,1084,43,0,0,0
35431,application_1506638472019_33586,1,34314,34314,35431,1117,1117,46,0,0,0
35441,application_1506638472019_33377,1,34280,34280,35441,1161,1161,50,0,0,0
35461,application_1506638472019_33328,1,34273,34273,35461,1188,1188,45,0,0,0
35491,application_1506638472019_33025,1,33856,33856,35491,1635,1635,67,0,0,0
35514,application_1506638472019_33848,1,34359,34359,35514,1155,1155,46,0,0,0
35514,application_1506638472019_33628,1,34323,34323,35514,1191,1191,80,0,0,0
35549,application_1506638472019_32060,1,32926,32926,35549,2623,2623,67,0,0,0
35549,application_1506638472019_33748,1,34342,34342,35549,1207,1207,57,0,0,0
35626,application_1506638472019_33601,1,34316,34316,35626,1310,1310,40,0,0,0
35686,application_1506638472019_34169,1,34466,34466,35686,1220,1220,58,0,0,0
35713,application_1506638472019_33322,1,34272,34272,35713,1441,1441,48,0,0,0
35713,application_1506638472019_32981,1,33722,33722,35713,1991,1991,63,0,0,0
35741,application_1506638472019_14553,1,21094,21094,35741,14647,14647,857,0,0,0
35751,application_1506638472019_17258,1,23434,23434,35751,12317,12317,618,0,0,0
35751,application_1506638472019_33671,1,34330,34330,35751,1421,1421,53,0,0,0
35761,application_1506638472019_33381,1,34280,34280,35761,1481,1481,56,0,0,0
35781,application_1506638472019_33364,1,34278,34278,35781,1503,1503,56,0,0,0
35781,application_1506638472019_27649,1,28833,28833,35781,6948,6948,269,0,0,0
35791,application_1506638472019_2894,1,13317,13317,35791,22474,22474,2448,0,0,0
35831,application_1506638472019_34422,1,34558,34558,35831,1273,1273,84,0,0,0
35926,application_1506638472019_33317,1,34271,34271,35926,1655,1655,51,0,0,0
35936,application_1506638472019_33580,1,34313,34313,35936,1623,1623,56,0,0,0
35936,application_1506638472019_3672,1,13538,13538,35936,22398,22398,2389,0,0,0
35962,application_1506638472019_33700,1,34334,34334,35962,1628,1628,49,0,0,0
35988,application_1506638472019_32629,1,33386,33386,35988,2602,2602,65,0,0,0
35988,application_1506638472019_33681,1,34331,34331,35988,1657,1657,61,0,0,0
36018,application_1506638472019_26482,1,28443,28443,36018,7575,7575,283,0,0,0
36028,application_1506638472019_33263,1,34261,34261,36028,1767,1767,42,0,0,0
36086,application_1506638472019_33602,1,34316,34316,36086,1770,1770,46,0,0,0
36112,application_1506638472019_12546,1,19012,19012,36112,17100,17100,960,0,0,0
36112,application_1506638472019_10151,1,17922,17922,36112,18190,18190,1209,0,0,0
36142,application_1506638472019_33329,1,34273,34273,36142,1869,1869,45,0,0,0
36162,application_1506638472019_33775,1,34346,34346,36162,1816,1816,62,0,0,0
36194,application_1506638472019_32935,1,33640,33640,36194,2554,2554,120,0,0,0
36204,application_1506638472019_28040,1,29077,29077,36204,7127,7127,261,0,0,0
36240,application_1506638472019_33643,1,34324,34324,36240,1916,1916,92,0,0,0
36258,application_1506638472019_32032,2,32858,32858,36258,3400,3400,14,0,0,0
36266,application_1506638472019_34419,1,34558,34558,36266,1708,1708,79,0,0,0
36266,application_1506638472019_10129,1,17911,17911,36266,18355,18355,1153,0,0,0
36266,application_1506638472019_36040,1,35103,35103,36266,1163,1163,33,0,0,0
36266,application_1506638472019_31727,2,31929,31929,36266,4337,4337,20,0,0,0
36276,application_1506638472019_34393,1,34546,34546,36276,1730,1730,64,0,0,0
36354,application_1506638472019_33019,1,33826,33826,36354,2528,2528,63,0,0,0
36368,application_1506638472019_33440,1,34290,34290,36368,2078,2078,51,0,0,0
36372,application_1506638472019_12514,1,19009,19009,36372,17363,17363,961,0,0,0
36382,application_1506638472019_33615,1,34319,34319,36382,2063,2063,55,0,0,0
36392,application_1506638472019_33805,1,34352,34352,36392,2040,2040,61,0,0,0
36422,application_1506638472019_12711,1,19560,19560,36422,16862,16862,898,0,0,0
36453,application_1506638472019_33747,1,34342,34342,36453,2111,2111,58,0,0,0
36463,application_1506638472019_33049,1,33966,33966,36463,2497,2497,73,0,0,0
36509,application_1506638472019_33245,1,34258,34258,36509,2251,2251,63,0,0,0
36529,application_1506638472019_34431,1,34560,34560,36529,1969,1969,86,0,0,0
36539,application_1506638472019_34503,1,34570,34570,36539,1969,1969,126,0,0,0
36539,application_1506638472019_12225,1,18846,18846,36539,17693,17693,960,0,0,0
36606,application_1506638472019_33307,1,34269,34269,36606,2337,2337,62,0,0,0
36636,application_1506638472019_33723,1,34337,34337,36636,2299,2299,55,0,0,0
36636,application_1506638472019_19261,4,24857,24857,36636,11779,11779,152,0,0,0
36701,application_1506638472019_34356,1,34536,34536,36701,2165,2165,85,0,0,0
36711,application_1506638472019_33751,1,34342,34342,36711,2369,2369,50,0,0,0
36725,application_1506638472019_34412,1,34557,34557,36725,2168,2168,99,0,0,0
36725,application_1506638472019_33624,1,34322,34322,36725,2403,2403,62,0,0,0
36743,application_1506638472019_14524,1,21082,21082,36743,15661,15661,851,0,0,0
36743,application_1506638472019_33646,1,34325,34325,36743,2418,2418,73,0,0,0
36759,application_1506638472019_10082,1,17883,17883,36759,18876,18876,1170,0,0,0
36819,application_1506638472019_34480,1,34566,34566,36819,2253,2253,75,0,0,0
36829,application_1506638472019_29247,1,29818,29818,36829,7011,7011,387,0,0,0
36856,application_1506638472019_14489,1,21073,21073,36856,15783,15783,902,0,0,0
36896,application_1506638472019_32877,1,33586,33586,36896,3310,3310,65,0,0,0
36896,application_1506638472019_3391,1,13426,13426,36896,23470,23470,2459,0,0,0
36916,application_1506638472019_33986,1,34409,34409,36916,2507,2507,76,0,0,0
36916,application_1506638472019_33841,1,34358,34358,36916,2558,2558,59,0,0,0
36976,application_1506638472019_1732,8,10373,10373,36976,26603,26603,3213,0,0,0
37028,application_1506638472019_2696,1,13303,13303,37028,23725,23725,2407,0,0,0
37037,application_1506638472019_34775,1,34640,34640,37037,2397,2397,140,0,0,0
37057,application_1506638472019_33766,1,34344,34344,37057,2713,2713,72,0,0,0
37119,application_1506638472019_10169,1,17927,17927,37119,19192,19192,1123,0,0,0
37124,application_1506638472019_34498,1,34569,34569,37124,2555,2555,82,0,0,0
37147,application_1506638472019_34500,1,34570,34570,37147,2577,2577,96,0,0,0
37156,application_1506638472019_35007,1,34716,34716,37156,2440,2440,69,0,0,0
37156,application_1506638472019_27647,1,28832,28832,37156,8324,8324,430,0,0,0
37183,application_1506638472019_24918,1,27763,27763,37183,9420,9420,399,0,0,0
37193,application_1506638472019_37953,1,36066,36066,37193,1127,1127,61,0,0,0
37203,application_1506638472019_35155,1,34856,34856,37203,2347,2347,75,0,0,0
37223,application_1506638472019_32276,1,33269,33269,37223,3954,3954,133,0,0,0
37276,application_1506638472019_34800,1,34642,34642,37276,2634,2634,141,0,0,0
37338,application_1506638472019_33851,1,34359,34359,37338,2979,2979,72,0,0,0
37368,application_1506638472019_37960,1,36086,36086,37368,1282,1282,73,0,0,0
37378,application_1506638472019_10113,1,17903,17903,37378,19475,19475,1165,0,0,0
37378,application_1506638472019_37351,1,35886,35886,37378,1492,1492,66,0,0,0
37386,application_1506638472019_24972,1,27769,27769,37386,9617,9617,404,0,0,0
37396,application_1506638472019_34433,1,34560,34560,37396,2836,2836,84,0,0,0
37504,application_1506638472019_36970,1,35526,35526,37504,1978,1978,65,0,0,0
37546,application_1506638472019_33730,1,34338,34338,37546,3208,3208,78,0,0,0
37556,application_1506638472019_37168,1,35656,35656,37556,1900,1900,82,0,0,0
37580,application_1506638472019_33018,2,33824,33824,37580,3756,3756,14,0,0,0
37606,application_1506638472019_34494,1,34568,34568,37606,3038,3038,141,0,0,0
37606,application_1506638472019_38113,1,36206,36206,37606,1400,1400,61,0,0,0
37676,application_1506638472019_14501,1,21076,21076,37676,16600,16600,889,0,0,0
37706,application_1506638472019_37150,1,35616,35616,37706,2090,2090,97,0,0,0
37728,application_1506638472019_9873,1,17825,17825,37728,19903,19903,1419,0,0,0
37768,application_1506638472019_39166,1,37124,37124,37768,644,644,35,0,0,0
37817,application_1506638472019_33374,2,34279,34279,37817,3538,3538,8,0,0,0
37848,application_1506638472019_24854,1,27757,27757,37848,10091,10091,405,0,0,0
37866,application_1506638472019_14475,1,21070,21070,37866,16796,16796,923,0,0,0
37906,application_1506638472019_28055,1,29078,29078,37906,8828,8828,244,0,0,0
37916,application_1506638472019_36034,1,35076,35076,37916,2840,2840,61,0,0,0
37987,application_1506638472019_36692,1,35356,35356,37987,2631,2631,65,0,0,0
38021,application_1506638472019_9874,1,17825,17825,38021,20196,20196,1276,0,0,0
38048,application_1506638472019_14518,1,21080,21080,38048,16968,16968,965,0,0,0
38084,application_1508364558011_0262,1,37416,37416,38084,668,668,40,0,0,0
38106,application_1506638472019_32052,1,32897,32897,38106,5209,5209,188,0,0,0
38116,application_1506638472019_38816,1,36759,36759,38116,1357,1357,49,0,0,0
38186,application_1506638472019_36682,1,35354,35354,38186,2832,2832,98,0,0,0
38186,application_1508364558011_0837,1,37930,37930,38186,256,256,13,0,0,0
38236,application_1506638472019_34497,1,34569,34569,38236,3667,3667,81,0,0,0
38306,application_1506638472019_34725,1,34634,34634,38306,3672,3672,136,0,0,0
38306,application_1506638472019_35809,1,35033,35033,38306,3273,3273,156,0,0,0
38346,application_1506638472019_36266,1,35149,35149,38346,3197,3197,153,0,0,0
38366,application_1506638472019_34808,1,34643,34643,38366,3723,3723,145,0,0,0
38366,application_1506638472019_38723,1,36716,36716,38366,1650,1650,66,0,0,0
38386,application_1506638472019_36260,1,35149,35149,38386,3237,3237,152,0,0,0
38396,application_1506638472019_38669,1,36556,36556,38396,1840,1840,66,0,0,0
38416,application_1506638472019_12814,1,19575,19575,38416,18841,18841,889,0,0,0
38416,application_1506638472019_11364,1,18715,18715,38416,19701,19701,1183,0,0,0
38447,application_1506638472019_31884,1,32336,32336,38447,6111,6111,163,0,0,0
38476,application_1508364558011_0257,1,37415,37415,38476,1061,1061,33,0,0,0
38516,application_1506638472019_37560,1,35956,35956,38516,2560,2560,65,0,0,0
38534,application_1506638472019_34401,1,34555,34555,38534,3979,3979,155,0,0,0
38544,application_1506638472019_34753,1,34638,34638,38544,3906,3906,154,0,0,0
38557,application_1506638472019_29263,1,29820,29820,38557,8737,8737,295,0,0,0
38576,application_1506638472019_12530,1,19011,19011,38576,19565,19565,961,0,0,0
38576,application_1506638472019_34416,1,34558,34558,38576,4018,4018,127,0,0,0
38596,application_1506638472019_39165,1,37124,37124,38596,1472,1472,32,0,0,0
38626,application_1506638472019_10077,1,17880,17880,38626,20746,20746,1121,0,0,0
38636,application_1506638472019_37108,1,35556,35556,38636,3080,3080,98,0,0,0
38756,application_1506638472019_32983,1,33728,33728,38756,5028,5028,260,0,0,0
38776,application_1506638472019_3189,1,13375,13375,38776,25401,25401,2591,0,0,0
38805,application_1506638472019_29178,1,29794,29794,38805,9011,9011,333,0,0,0
38805,application_1506638472019_39193,1,37156,37156,38805,1649,1649,71,0,0,0
38807,application_1506638472019_10496,1,18549,18549,38807,20258,20258,1081,0,0,0
38826,application_1508364558011_0311,1,37466,37466,38826,1360,1360,62,0,0,0
38834,application_1506638472019_36248,1,35148,35148,38834,3686,3686,156,0,0,0
38834,application_1506638472019_38326,1,36266,36266,38834,2568,2568,71,0,0,0
38842,application_1506638472019_2695,1,13302,13302,38842,25540,25540,2514,0,0,0
38852,application_1506638472019_36196,1,35143,35143,38852,3709,3709,151,0,0,0
38869,application_1506638472019_14551,1,21092,21092,38869,17777,17777,896,0,0,0
38976,application_1506638472019_34900,1,34651,34651,38976,4325,4325,137,0,0,0
38995,application_1506638472019_24882,1,27759,27759,38995,11236,11236,393,0,0,0
39002,application_1506638472019_3383,1,13426,13426,39002,25576,25576,2475,0,0,0
39056,application_1506638472019_29176,1,29794,29794,39056,9262,9262,346,0,0,0
39066,application_1506638472019_29186,1,29804,29804,39066,9262,9262,319,0,0,0
39076,application_1506638472019_38840,1,36836,36836,39076,2240,2240,67,0,0,0
39151,application_1506638472019_25004,1,27773,27773,39151,11378,11378,398,0,0,0
39171,application_1506638472019_34782,1,34641,34641,39171,4530,4530,144,0,0,0
39181,application_1506638472019_38665,1,36546,36546,39181,2635,2635,63,0,0,0
39191,application_1506638472019_36296,1,35152,35152,39191,4039,4039,155,0,0,0
39196,application_1506638472019_10088,1,17884,17884,39196,21312,21312,1239,0,0,0
39225,application_1508364558011_0571,1,37666,37666,39225,1559,1559,60,0,0,0
39225,application_1506638472019_36214,1,35145,35145,39225,4080,4080,159,0,0,0
39248,application_1506638472019_22935,1,27006,27006,39248,12242,12242,545,0,0,0
39254,application_1506638472019_35796,1,35032,35032,39254,4222,4222,152,0,0,0
39254,application_1506638472019_3465,1,13433,13433,39254,25821,25821,2439,0,0,0
39256,application_1506638472019_36498,2,35230,35230,39256,4026,4026,16,0,0,0
39276,application_1506638472019_22785,1,26991,26991,39276,12285,12285,545,0,0,0
39308,application_1506638472019_12050,1,18810,18810,39308,20498,20498,1415,0,0,0
39331,application_1508364558011_0492,1,37596,37596,39331,1735,1735,63,0,0,0
39358,application_1506638472019_9846,1,17823,17823,39358,21535,21535,1212,0,0,0
39373,application_1506638472019_24888,1,27760,27760,39373,11613,11613,413,0,0,0
39393,application_1506638472019_34915,1,34653,34653,39393,4740,4740,238,0,0,0
39403,application_1506638472019_38915,1,36976,36976,39403,2427,2427,76,0,0,0
39413,application_1506638472019_37200,1,35716,35716,39413,3697,3697,69,0,0,0
39417,application_1506638472019_2663,1,13300,13300,39417,26117,26117,2428,0,0,0
39457,application_1508364558011_0518,1,37626,37626,39457,1831,1831,63,0,0,0
39517,application_1506638472019_3642,1,13535,13535,39517,25982,25982,2496,0,0,0
39566,application_1506638472019_9844,1,17822,17822,39566,21744,21744,1156,0,0,0
39566,application_1506638472019_2980,1,13324,13324,39566,26242,26242,2532,0,0,0
39586,application_1506638472019_2965,1,13323,13323,39586,26263,26263,2487,0,0,0
39596,application_1506638472019_35237,1,34894,34894,39596,4702,4702,218,0,0,0
39626,application_1506638472019_14467,1,21066,21066,39626,18560,18560,880,0,0,0
39656,application_1506638472019_34752,1,34637,34637,39656,5019,5019,145,0,0,0
39666,application_1508364558011_1086,1,38306,38306,39666,1360,1360,75,0,0,0
39676,application_1506638472019_14481,1,21071,21071,39676,18605,18605,909,0,0,0
39686,application_1508364558011_0757,1,37807,37807,39686,1879,1879,76,0,0,0
39696,application_1506638472019_3351,1,13388,13388,39696,26308,26308,2753,0,0,0
39736,application_1506638472019_38919,1,36986,36986,39736,2750,2750,77,0,0,0
39746,application_1506638472019_38854,1,36896,36896,39746,2850,2850,74,0,0,0
39756,application_1506638472019_11369,1,18716,18716,39756,21040,21040,1084,0,0,0
39776,application_1506638472019_36256,1,35148,35148,39776,4628,4628,160,0,0,0
39776,application_1506638472019_35790,1,35030,35030,39776,4746,4746,155,0,0,0
39799,application_1506638472019_35819,1,35034,35034,39799,4765,4765,270,0,0,0
39831,application_1506638472019_39172,1,37136,37136,39831,2695,2695,60,0,0,0
39882,application_1506638472019_34902,1,34651,34651,39882,5231,5231,144,0,0,0
39902,application_1508364558011_3013,1,39131,39131,39902,771,771,17,0,0,0
39943,application_1506638472019_14537,1,21086,21086,39943,18857,18857,873,0,0,0
39967,application_1506638472019_36286,1,35151,35151,39967,4816,4816,167,0,0,0
39997,application_1506638472019_35867,1,35038,35038,39997,4959,4959,158,0,0,0
40026,application_1506638472019_35235,1,34894,34894,40026,5132,5132,210,0,0,0
40041,application_1506638472019_11377,1,18717,18717,40041,21324,21324,1184,0,0,0
40053,application_1506638472019_35254,1,34897,34897,40053,5156,5156,214,0,0,0
40118,application_1506638472019_34904,1,34651,34651,40118,5467,5467,253,0,0,0
40118,application_1506638472019_10092,1,17885,17885,40118,22233,22233,1194,0,0,0
40148,application_1506638472019_3210,1,13376,13376,40148,26772,26772,2368,0,0,0
40174,application_1506638472019_35256,1,34898,34898,40174,5276,5276,204,0,0,0
40216,application_1508364558011_0984,1,38084,38084,40216,2132,2132,49,0,0,0
40233,application_1508364558011_0359,1,37536,37536,40233,2697,2697,62,0,0,0
40263,application_1506638472019_3399,1,13427,13427,40263,26836,26836,2366,0,0,0
40320,application_1506638472019_39321,1,37226,37226,40320,3094,3094,68,0,0,0
40327,application_1508364558011_0778,1,37828,37828,40327,2499,2499,57,0,0,0
40347,application_1506638472019_35253,1,34897,34897,40347,5450,5450,218,0,0,0
40377,application_1508364558011_0513,1,37622,37622,40377,2755,2755,79,0,0,0
40396,application_1506638472019_36309,1,35154,35154,40396,5242,5242,154,0,0,0
40436,application_1506638472019_38666,2,36548,36548,40436,3888,3888,110,0,0,0
40526,application_1506638472019_24862,1,27758,27758,40526,12768,12768,392,0,0,0
40556,application_1506638472019_3639,1,13535,13535,40556,27021,27021,2449,0,0,0
40566,application_1508364558011_3067,1,39151,39151,40566,1415,1415,63,0,0,0
40576,application_1506638472019_10235,1,18113,18113,40576,22463,22463,1191,0,0,0
40604,application_1508364558011_0498,1,37612,37612,40604,2992,2992,99,0,0,0
40628,application_1508364558011_4524,1,39596,39596,40628,1032,1032,69,0,0,0
40628,application_1506638472019_34893,1,34650,34650,40628,5978,5978,154,0,0,0
40635,application_1508364558011_5998,1,40223,40223,40635,412,412,32,0,0,0
40676,application_1506638472019_34870,1,34648,34648,40676,6028,6028,250,0,0,0
40686,application_1506638472019_31408,1,31461,31461,40686,9225,9225,388,0,0,0
40711,application_1506638472019_10125,1,17909,17909,40711,22802,22802,1179,0,0,0
40730,application_1506638472019_35854,1,35037,35037,40730,5693,5693,168,0,0,0
40750,application_1508364558011_0983,1,38078,38078,40750,2672,2672,66,0,0,0
40760,application_1506638472019_38921,2,36988,36988,40760,3772,3772,17,0,0,0
40780,application_1506638472019_37204,1,35721,35721,40780,5059,5059,194,0,0,0
40780,application_1506638472019_38944,2,37029,37029,40780,3751,3751,15,0,0,0
40790,application_1506638472019_34861,1,34647,34647,40790,6143,6143,245,0,0,0
40836,application_1506638472019_35271,1,34900,34900,40836,5936,5936,210,0,0,0
40846,application_1506638472019_14479,1,21071,21071,40846,19775,19775,904,0,0,0
40866,application_1508364558011_1397,1,38566,38566,40866,2300,2300,85,0,0,0
40866,application_1508364558011_1981,1,38856,38856,40866,2010,2010,73,0,0,0
40886,application_1508364558011_0995,1,38146,38146,40886,2740,2740,80,0,0,0
40896,application_1506638472019_39173,2,37137,37137,40896,3759,3759,116,0,0,0
40896,application_1506638472019_24901,4,27761,27761,40896,13135,13135,149,0,0,0
40926,application_1508364558011_1760,1,38826,38826,40926,2100,2100,69,0,0,0
40936,application_1508364558011_2068,1,38876,38876,40936,2060,2060,71,0,0,0
40966,application_1508364558011_0499,1,37614,37614,40966,3352,3352,125,0,0,0
40976,application_1506638472019_34830,1,34645,34645,40976,6331,6331,232,0,0,0
40986,application_1506638472019_34919,1,34653,34653,40986,6333,6333,238,0,0,0
41016,application_1506638472019_35814,1,35034,35034,41016,5982,5982,151,0,0,0
41046,application_1506638472019_35366,1,34925,34925,41046,6121,6121,203,0,0,0
41046,application_1506638472019_39297,1,37163,37163,41046,3883,3883,182,0,0,0
41066,application_1506638472019_33193,1,34186,34186,41066,6880,6880,307,0,0,0
41066,application_1506638472019_22817,1,26994,26994,41066,14072,14072,555,0,0,0
41066,application_1506638472019_24987,1,27771,27771,41066,13295,13295,402,0,0,0
41146,application_1506638472019_11373,1,18716,18716,41146,22430,22430,1082,0,0,0
41213,application_1508364558011_1080,1,38286,38286,41213,2927,2927,67,0,0,0
41223,application_1506638472019_2768,1,13307,13307,41223,27916,27916,2371,0,0,0
41243,application_1508364558011_5501,1,40026,40026,41243,1217,1217,66,0,0,0
41273,application_1506638472019_34705,1,34632,34632,41273,6641,6641,235,0,0,0
41278,application_1506638472019_36301,1,35152,35152,41278,6126,6126,153,0,0,0
41294,application_1506638472019_4408,8,15336,15336,41294,25958,25958,901,0,0,0
41306,application_1506638472019_36223,1,35146,35146,41306,6160,6160,274,0,0,0
41316,application_1508364558011_0039,2,37288,37288,41316,4028,4028,29,0,0,0
41481,application_1508364558011_1866,1,38846,38846,41481,2635,2635,77,0,0,0
41504,application_1506638472019_35236,1,34894,34894,41504,6610,6610,219,0,0,0
41547,application_1506638472019_14493,1,21074,21074,41547,20473,20473,995,0,0,0
41567,application_1508364558011_0989,1,38116,38116,41567,3451,3451,58,0,0,0
41599,application_1508364558011_0986,1,38096,38096,41599,3503,3503,98,0,0,0
41638,application_1506638472019_3218,1,13377,13377,41638,28261,28261,2673,0,0,0
41688,application_1508364558011_1491,1,38716,38716,41688,2972,2972,72,0,0,0
41698,application_1508364558011_5386,1,39916,39916,41698,1782,1782,74,0,0,0
41708,application_1508364558011_1526,1,38726,38726,41708,2982,2982,73,0,0,0
41708,application_1506638472019_3101,1,13368,13368,41708,28340,28340,2487,0,0,0
41708,application_1506638472019_31963,1,32659,32659,41708,9049,9049,328,0,0,0
41778,application_1506638472019_10131,1,17913,17913,41778,23865,23865,1229,0,0,0
41778,application_1506638472019_39291,1,37162,37162,41778,4616,4616,151,0,0,0
41818,application_1506638472019_3072,1,13366,13366,41818,28452,28452,2379,0,0,0
41828,application_1506638472019_12145,1,18820,18820,41828,23008,23008,1433,0,0,0
41828,application_1506638472019_4427,1,15375,15375,41828,26453,26453,1842,0,0,0
41864,application_1506638472019_11339,1,18712,18712,41864,23152,23152,1478,0,0,0
41874,application_1506638472019_2778,1,13308,13308,41874,28566,28566,2475,0,0,0
41926,application_1508364558011_6455,1,40796,40796,41926,1130,1130,63,0,0,0
41936,application_1506638472019_35871,1,35039,35039,41936,6897,6897,156,0,0,0
41976,application_1506638472019_36200,1,35144,35144,41976,6832,6832,271,0,0,0
41976,application_1508364558011_1059,1,38246,38246,41976,3730,3730,114,0,0,0
42006,application_1506638472019_35241,1,34895,34895,42006,7111,7111,282,0,0,0
42055,application_1506638472019_3040,1,13363,13363,42055,28692,28692,2800,0,0,0
42060,application_1508364558011_0515,1,37622,37622,42060,4438,4438,119,0,0,0
42088,application_1508364558011_1158,1,38426,38426,42088,3662,3662,152,0,0,0
42108,application_1506638472019_10498,1,18549,18549,42108,23559,23559,1181,0,0,0
42118,application_1508364558011_2113,1,38966,38966,42118,3152,3152,67,0,0,0
42128,application_1506638472019_3037,1,13363,13363,42128,28765,28765,2403,0,0,0
42140,application_1508364558011_3049,1,39143,39143,42140,2997,2997,79,0,0,0
42161,application_1508364558011_5960,1,40164,40164,42161,1997,1997,26,0,0,0
42185,application_1506638472019_39234,1,37159,37159,42185,5026,5026,172,0,0,0
42221,application_1508364558011_6102,1,40436,40436,42221,1785,1785,68,0,0,0
42241,application_1506638472019_35880,1,35041,35041,42241,7200,7200,272,0,0,0
42241,application_1508364558011_1025,1,38224,38224,42241,4017,4017,97,0,0,0
42281,application_1506638472019_35862,1,35038,35038,42281,7243,7243,278,0,0,0
42291,application_1508364558011_6199,1,40516,40516,42291,1775,1775,68,0,0,0
42301,application_1508364558011_1279,1,38480,38480,42301,3821,3821,144,0,0,0
42321,application_1506638472019_32865,1,33560,33560,42321,8761,8761,350,0,0,0
42351,application_1508364558011_3128,1,39196,39196,42351,3155,3155,95,0,0,0
42419,application_1508364558011_6218,1,40566,40566,42419,1853,1853,68,0,0,0
42449,application_1506638472019_10493,1,18548,18548,42449,23901,23901,1175,0,0,0
42469,application_1508364558011_5994,1,40216,40216,42469,2253,2253,99,0,0,0
42489,application_1506638472019_34227,1,34519,34519,42489,7970,7970,337,0,0,0
42509,application_1506638472019_39189,1,37156,37156,42509,5353,5353,167,0,0,0
42529,application_1506638472019_38653,1,36509,36509,42529,6020,6020,120,0,0,0
42539,application_1508364558011_5925,1,40078,40078,42539,2461,2461,34,0,0,0
42599,application_1506638472019_18547,1,24607,24607,42599,17992,17992,963,0,0,0
42619,application_1506638472019_35219,1,34891,34891,42619,7728,7728,222,0,0,0
42706,application_1508364558011_6948,1,40986,40986,42706,1720,1720,60,0,0,0
42766,application_1506638472019_33801,1,34351,34351,42766,8415,8415,259,0,0,0
42766,application_1506638472019_34887,1,34650,34650,42766,8116,8116,243,0,0,0
42766,application_1506638472019_11396,1,18718,18718,42766,24048,24048,1418,0,0,0
42776,application_1508364558011_6941,1,40936,40936,42776,1840,1840,64,0,0,0
42838,application_1506638472019_25733,4,27902,27902,42838,14936,14936,776,0,0,0
42866,application_1508364558011_7500,1,41376,41376,42866,1490,1490,70,0,0,0
42902,application_1506638472019_35884,1,35042,35042,42902,7860,7860,293,0,0,0
42905,application_1508364558011_4541,1,39716,39716,42905,3189,3189,73,0,0,0
42938,application_1508364558011_1893,1,38852,38852,42938,4086,4086,207,0,0,0
42938,application_1506638472019_20966,1,26124,26124,42938,16814,16814,642,0,0,0
42948,application_1508364558011_6094,1,40396,40396,42948,2552,2552,66,0,0,0
42968,application_1508364558011_2071,1,38887,38887,42968,4081,4081,75,0,0,0
42968,application_1506638472019_2822,1,13312,13312,42968,29656,29656,2437,0,0,0
42978,application_1506638472019_24389,1,27615,27615,42978,15363,15363,597,0,0,0
42978,application_1506638472019_35227,1,34893,34893,42978,8085,8085,272,0,0,0
43013,application_1506638472019_11861,1,18788,18788,43013,24225,24225,1504,0,0,0
43056,application_1506638472019_11430,1,18722,18722,43056,24334,24334,1157,0,0,0
43072,application_1508364558011_7488,1,41296,41296,43072,1776,1776,59,0,0,0
43092,application_1508364558011_8001,1,41616,41616,43092,1476,1476,65,0,0,0
43092,application_1506638472019_35218,1,34891,34891,43092,8201,8201,281,0,0,0
43123,application_1508364558011_1283,1,38481,38481,43123,4642,4642,187,0,0,0
43143,application_1506638472019_3318,1,13384,13384,43143,29759,29759,2537,0,0,0
43186,application_1506638472019_34796,1,34642,34642,43186,8544,8544,239,0,0,0
43198,application_1506638472019_34905,1,34651,34651,43198,8547,8547,256,0,0,0
43256,application_1506638472019_3279,1,13381,13381,43256,29875,29875,2458,0,0,0
43334,application_1506638472019_36305,1,35153,35153,43334,8181,8181,280,0,0,0
43426,application_1508364558011_3764,1,39276,39276,43426,4150,4150,123,0,0,0
43426,application_1506638472019_24520,1,27697,27697,43426,15729,15729,707,0,0,0
43440,application_1506638472019_11709,1,18773,18773,43440,24667,24667,1425,0,0,0
43446,application_1506638472019_38644,1,36480,36480,43446,6966,6966,229,0,0,0
43470,application_1506638472019_3502,1,13435,13435,43470,30035,30035,2346,0,0,0
43574,application_1508364558011_4520,1,39576,39576,43574,3998,3998,86,0,0,0
43584,application_1508364558011_1299,1,38482,38482,43584,5102,5102,179,0,0,0
43629,application_1508364558011_6098,1,40416,40416,43629,3213,3213,74,0,0,0
43678,application_1508364558011_4536,1,39686,39686,43678,3992,3992,86,0,0,0
43706,application_1508364558011_6350,1,40666,40666,43706,3040,3040,69,0,0,0
43716,application_1508364558011_5254,1,39867,39867,43716,3849,3849,78,0,0,0
43726,application_1506638472019_2760,1,13307,13307,43726,30419,30419,2645,0,0,0
43736,application_1506638472019_39258,1,37160,37160,43736,6576,6576,153,0,0,0
43736,application_1506638472019_32977,1,33722,33722,43736,10014,10014,281,0,0,0
43806,application_1506638472019_10785,1,18643,18643,43806,25163,25163,1434,0,0,0
43826,application_1506638472019_11980,1,18802,18802,43826,25024,25024,1450,0,0,0
43826,application_1508364558011_1300,1,38482,38482,43826,5344,5344,204,0,0,0
43836,application_1508364558011_1298,1,38482,38482,43836,5354,5354,165,0,0,0
43846,application_1506638472019_36250,1,35148,35148,43846,8698,8698,280,0,0,0
43911,application_1508364558011_4515,1,39546,39546,43911,4365,4365,145,0,0,0
43947,application_1508364558011_1308,1,38483,38483,43947,5464,5464,158,0,0,0
43958,application_1508364558011_5470,1,39936,39936,43958,4022,4022,64,0,0,0
44006,application_1508364558011_9218,1,41876,41876,44006,2130,2130,67,0,0,0
44066,application_1508364558011_7625,1,41476,41476,44066,2590,2590,73,0,0,0
44086,application_1506638472019_39236,1,37159,37159,44086,6927,6927,175,0,0,0
44146,application_1508364558011_1296,1,38482,38482,44146,5664,5664,157,0,0,0
44188,application_1506638472019_9878,1,17825,17825,44188,26363,26363,1194,0,0,0
44198,application_1508364558011_5260,1,39867,39867,44198,4331,4331,95,0,0,0
44198,application_1506638472019_24508,1,27695,27695,44198,16503,16503,682,0,0,0
44260,application_1506638472019_14567,1,21124,21124,44260,23136,23136,1186,0,0,0
44272,application_1506638472019_12733,1,19564,19564,44272,24708,24708,1085,0,0,0
44332,application_1506638472019_11943,1,18799,18799,44332,25533,25533,1464,0,0,0
44352,application_1508364558011_9221,1,41896,41896,44352,2456,2456,68,0,0,0
44377,application_1508364558011_1286,1,38481,38481,44377,5896,5896,144,0,0,0
44386,application_1508364558011_1348,1,38486,38486,44386,5900,5900,159,0,0,0
44423,application_1508364558011_10721,1,42186,42186,44423,2237,2237,79,0,0,0
44423,application_1506638472019_3100,1,13368,13368,44423,31055,31055,2413,0,0,0
44477,application_1508364558011_1339,1,38485,38485,44477,5992,5992,187,0,0,0
44496,application_1506638472019_10262,1,18177,18177,44496,26319,26319,1253,0,0,0
44496,application_1508364558011_6959,1,41036,41036,44496,3460,3460,68,0,0,0
44529,application_1508364558011_0964,2,38028,38028,44529,6501,6501,8,0,0,0
44636,application_1508364558011_9240,1,41986,41986,44636,2650,2650,91,0,0,0
44691,application_1506638472019_23100,1,27144,27144,44691,17547,17547,646,0,0,0
44809,application_1506638472019_4027,1,14317,14317,44809,30492,30492,2216,0,0,0
44819,application_1506638472019_10154,1,17922,17922,44819,26897,26897,1200,0,0,0
44836,application_1506638472019_39262,1,37161,37161,44836,7675,7675,159,0,0,0
44952,application_1508364558011_11894,1,43446,43446,44952,1506,1506,61,0,0,0
44954,application_1508364558011_9545,1,42066,42066,44954,2888,2888,65,0,0,0
44976,application_1508364558011_6105,1,40466,40466,44976,4510,4510,70,0,0,0
44985,application_1506638472019_2818,1,13312,13312,44985,31673,31673,2404,0,0,0
45034,application_1506638472019_36235,1,35147,35147,45034,9887,9887,282,0,0,0
45044,application_1508364558011_7623,1,41466,41466,45044,3578,3578,73,0,0,0
45054,application_1508364558011_1293,1,38481,38481,45054,6573,6573,237,0,0,0
45064,application_1508364558011_6212,1,40536,40536,45064,4528,4528,68,0,0,0
45122,application_1506638472019_10672,1,18630,18630,45122,26492,26492,1459,0,0,0
45122,application_1508364558011_11414,1,43226,43226,45122,1896,1896,68,0,0,0
45176,application_1506638472019_35213,1,34890,34890,45176,10286,10286,370,0,0,0
45220,application_1508364558011_1265,1,38478,38478,45220,6742,6742,183,0,0,0
45220,application_1508364558011_3109,1,39181,39181,45220,6039,6039,128,0,0,0
45240,application_1508364558011_11507,1,43296,43296,45240,1944,1944,65,0,0,0
45257,application_1508364558011_1006,1,38176,38176,45257,7081,7081,67,0,0,0
45267,application_1506638472019_37700,1,35975,35975,45267,9292,9292,346,0,0,0
45287,application_1508364558011_1327,1,38484,38484,45287,6803,6803,202,0,0,0
45297,application_1508364558011_11169,1,43006,43006,45297,2291,2291,79,0,0,0
45307,application_1506638472019_36203,1,35144,35144,45307,10163,10163,276,0,0,0
45345,application_1508364558011_1161,1,38427,38427,45345,6918,6918,183,0,0,0
45363,application_1508364558011_1246,1,38476,38476,45363,6887,6887,174,0,0,0
45379,application_1506638472019_27737,4,28935,28935,45379,16444,16444,139,0,0,0
45402,application_1506638472019_36137,1,35134,35134,45402,10268,10268,468,0,0,0
45412,application_1506638472019_12098,1,18815,18815,45412,26597,26597,1491,0,0,0
45422,application_1506638472019_27740,4,28935,28935,45422,16487,16487,41,0,0,0
45442,application_1506638472019_2767,1,13307,13307,45442,32135,32135,2514,0,0,0
45452,application_1508364558011_10822,1,42656,42656,45452,2796,2796,68,0,0,0
45472,application_1508364558011_1162,1,38427,38427,45472,7045,7045,204,0,0,0
45512,application_1508364558011_13415,1,44496,44496,45512,1016,1016,64,0,0,0
45522,application_1508364558011_1278,1,38480,38480,45522,7042,7042,175,0,0,0
45532,application_1508364558011_10724,1,42201,42201,45532,3331,3331,110,0,0,0
45562,application_1508364558011_13951,1,44836,44836,45562,726,726,59,0,0,0
45562,application_1506638472019_2806,1,13311,13311,45562,32251,32251,2627,0,0,0
45579,application_1506638472019_25330,1,27823,27823,45579,17756,17756,550,0,0,0
45609,application_1506638472019_32343,1,33310,33310,45609,12299,12299,379,0,0,0
45637,application_1508364558011_12669,1,43596,43596,45637,2041,2041,74,0,0,0
45657,application_1508364558011_13428,1,44529,44529,45657,1128,1128,34,0,0,0
45774,application_1506638472019_38618,2,36423,36423,45774,9351,9351,1014,0,0,0
45816,application_1506638472019_11944,1,18799,18799,45816,27017,27017,1442,0,0,0
45816,application_1508364558011_6067,2,40327,40327,45816,5489,5489,33,0,0,0
45836,application_1508364558011_12789,1,43706,43706,45836,2130,2130,68,0,0,0
45843,application_1506638472019_3414,1,13428,13428,45843,32415,32415,2437,0,0,0
45847,application_1508364558011_6097,2,40409,40409,45847,5438,5438,31,0,0,0
45881,application_1508364558011_6364,2,40704,40704,45881,5177,5177,31,0,0,0
45891,application_1506638472019_12750,1,19567,19567,45891,26324,26324,1104,0,0,0
45996,application_1508364558011_13087,1,43996,43996,45996,2000,2000,62,0,0,0
46006,application_1506638472019_4732,1,15743,15743,46006,30263,30263,1496,0,0,0
46075,application_1506638472019_35350,1,34922,34922,46075,11153,11153,369,0,0,0
46095,application_1508364558011_13152,1,44136,44136,46095,1959,1959,69,0,0,0
46115,application_1508364558011_14049,1,44866,44866,46115,1249,1249,66,0,0,0
46125,application_1508364558011_13224,1,44226,44226,46125,1899,1899,63,0,0,0
46226,application_1506638472019_37737,1,35978,35978,46226,10248,10248,360,0,0,0
46226,application_1508364558011_13417,1,44500,44500,46226,1726,1726,74,0,0,0
46256,application_1508364558011_13174,1,44146,44146,46256,2110,2110,63,0,0,0
46309,application_1508364558011_1144,1,38422,38422,46309,7887,7887,176,0,0,0
46322,application_1506638472019_3303,1,13383,13383,46322,32939,32939,2672,0,0,0
46343,application_1508364558011_13416,1,44499,44499,46343,1844,1844,80,0,0,0
46353,application_1506638472019_37660,1,35974,35974,46353,10379,10379,453,0,0,0
46364,application_1508364558011_1332,1,38484,38484,46364,7880,7880,206,0,0,0
46374,application_1506638472019_2830,1,13313,13313,46374,33061,33061,2731,0,0,0
46423,application_1506638472019_2769,1,13307,13307,46423,33116,33116,2415,0,0,0
46433,application_1506638472019_10837,1,18649,18649,46433,27784,27784,1424,0,0,0
46515,application_1508364558011_12257,1,43517,43517,46515,2998,2998,98,0,0,0
46636,application_1506638472019_10971,1,18661,18661,46636,27975,27975,1548,0,0,0
46666,application_1508364558011_15912,1,46249,46249,46666,417,417,30,0,0,0
46769,application_1506638472019_35863,1,35038,35038,46769,11731,11731,277,0,0,0
46806,application_1506638472019_12162,1,18822,18822,46806,27984,27984,1549,0,0,0
46936,application_1508364558011_15783,1,46065,46065,46936,871,871,34,0,0,0
46936,application_1506638472019_37894,1,36038,36038,46936,10898,10898,404,0,0,0
46946,application_1506638472019_11862,1,18788,18788,46946,28158,28158,1440,0,0,0
46976,application_1508364558011_10954,1,42892,42892,46976,4084,4084,143,0,0,0
46996,application_1506638472019_3315,1,13384,13384,46996,33612,33612,2459,0,0,0
47006,application_1508364558011_4528,1,39626,39626,47006,7380,7380,142,0,0,0
47016,application_1508364558011_12766,1,43658,43658,47016,3358,3358,66,0,0,0
47016,application_1508364558011_13195,1,44178,44178,47016,2838,2838,78,0,0,0
47026,application_1506638472019_10815,1,18646,18646,47026,28380,28380,1438,0,0,0
47066,application_1506638472019_12398,1,18872,18872,47066,28194,28194,1468,0,0,0
47076,application_1508364558011_12908,1,43786,43786,47076,3290,3290,57,0,0,0
47178,application_1508364558011_11383,1,43156,43156,47178,4022,4022,63,0,0,0
47311,application_1508364558011_1191,1,38454,38454,47311,8857,8857,249,0,0,0
47336,application_1508364558011_16986,1,47152,47152,47336,184,184,10,0,0,0
47336,application_1508364558011_12184,1,43506,43506,47336,3830,3830,69,0,0,0
47366,application_1506638472019_3509,1,13436,13436,47366,33930,33930,2388,0,0,0
47436,application_1506638472019_3685,1,13539,13539,47436,33897,33897,2808,0,0,0
47486,application_1508364558011_2647,1,39051,39051,47486,8435,8435,272,0,0,0
47521,application_1508364558011_16991,1,47158,47158,47521,363,363,9,0,0,0
47551,application_1506638472019_2935,1,13320,13320,47551,34231,34231,2545,0,0,0
47561,application_1508364558011_14327,1,44966,44966,47561,2595,2595,66,0,0,0
47581,application_1506638472019_34850,1,34646,34646,47581,12935,12935,240,0,0,0
47591,application_1508364558011_5910,1,40053,40053,47591,7538,7538,225,0,0,0
47621,application_1506638472019_10868,1,18652,18652,47621,28969,28969,1447,0,0,0
47628,application_1508364558011_13218,1,44216,44216,47628,3412,3412,70,0,0,0
47682,application_1506638472019_37855,1,36037,36037,47682,11645,11645,451,0,0,0
47761,application_1508364558011_17048,1,47266,47266,47761,495,495,8,0,0,0
47796,application_1508364558011_13389,1,44477,44477,47796,3319,3319,64,0,0,0
47871,application_1508364558011_16545,1,46596,46596,47871,1275,1275,68,0,0,0
47881,application_1506638472019_3522,1,13437,13437,47881,34444,34444,2564,0,0,0
47888,application_1508364558011_10937,1,42866,42866,47888,5022,5022,68,0,0,0
47920,application_1508364558011_15454,1,45696,45696,47920,2224,2224,77,0,0,0
48011,application_1506638472019_2772,1,13308,13308,48011,34703,34703,2815,0,0,0
48013,application_1506638472019_11811,1,18783,18783,48013,29230,29230,1449,0,0,0
48047,application_1506638472019_3574,1,13486,13486,48047,34561,34561,2381,0,0,0
48140,application_1506638472019_2685,1,13302,13302,48140,34838,34838,2563,0,0,0
48140,application_1508364558011_2638,1,39042,39042,48140,9098,9098,332,0,0,0
48140,application_1508364558011_9535,2,42066,42066,48140,6074,6074,16,0,0,0
48160,application_1506638472019_10872,1,18653,18653,48160,29507,29507,1447,0,0,0
48160,application_1508364558011_10720,2,42185,42185,48160,5975,5975,19,0,0,0
48170,application_1508364558011_6020,1,40243,40243,48170,7927,7927,125,0,0,0
48199,application_1508364558011_11357,2,43103,43103,48199,5096,5096,14,0,0,0
48209,application_1508364558011_13192,1,44176,44176,48209,4033,4033,72,0,0,0
48251,application_1508364558011_16942,1,47093,47093,48251,1158,1158,28,0,0,0
48263,application_1508364558011_15883,1,46206,46206,48263,2057,2057,69,0,0,0
48303,application_1508364558011_16861,1,46906,46906,48303,1397,1397,68,0,0,0
48434,application_1508364558011_16325,1,46496,46496,48434,1938,1938,70,0,0,0
48454,application_1508364558011_17922,1,47881,47881,48454,573,573,53,0,0,0
48454,application_1508364558011_17973,1,47896,47896,48454,558,558,56,0,0,0
48546,application_1508364558011_12917,1,43826,43826,48546,4720,4720,69,0,0,0
48556,application_1506638472019_11742,1,18777,18777,48556,29779,29779,1477,0,0,0
48606,application_1508364558011_17993,1,47899,47899,48606,707,707,46,0,0,0
48636,application_1508364558011_16439,1,46546,46546,48636,2090,2090,72,0,0,0
48656,application_1508364558011_15818,1,46137,46137,48656,2519,2519,78,0,0,0
48696,application_1508364558011_14306,1,44956,44956,48696,3740,3740,61,0,0,0
48706,application_1506638472019_3530,1,13438,13438,48706,35268,35268,2424,0,0,0
48766,application_1508364558011_14570,1,45156,45156,48766,3610,3610,67,0,0,0
48781,application_1508364558011_17982,1,47897,47897,48781,884,884,47,0,0,0
48796,application_1508364558011_15494,1,45796,45796,48796,3000,3000,71,0,0,0
48824,application_1508364558011_2121,1,38987,38987,48824,9837,9837,326,0,0,0
48886,application_1506638472019_3077,1,13366,13366,48886,35520,35520,2706,0,0,0
48912,application_1506638472019_11129,1,18677,18677,48912,30235,30235,1508,0,0,0
48922,application_1508364558011_16686,1,46706,46706,48922,2216,2216,63,0,0,0
48962,application_1508364558011_13324,1,44367,44367,48962,4595,4595,121,0,0,0
48972,application_1508364558011_18232,1,47930,47930,48972,1042,1042,49,0,0,0
48982,application_1506638472019_11916,1,18794,18794,48982,30188,30188,1481,0,0,0
48996,application_1508364558011_13893,1,44789,44789,48996,4207,4207,88,0,0,0
49004,application_1506638472019_3259,1,13380,13380,49004,35624,35624,2442,0,0,0
49014,application_1508364558011_18010,1,47901,47901,49014,1113,1113,40,0,0,0
49024,application_1506638472019_11991,1,18804,18804,49024,30220,30220,1439,0,0,0
49044,application_1506638472019_10926,1,18657,18657,49044,30387,30387,1419,0,0,0
49085,application_1508364558011_13928,1,44826,44826,49085,4259,4259,69,0,0,0
49095,application_1508364558011_17942,1,47888,47888,49095,1207,1207,45,0,0,0
49105,application_1508364558011_18227,1,47929,47929,49105,1176,1176,43,0,0,0
49137,application_1506638472019_11789,1,18781,18781,49137,30356,30356,1503,0,0,0
49147,application_1508364558011_18044,1,47905,47905,49147,1242,1242,49,0,0,0
49157,application_1508364558011_17056,1,47266,47266,49157,1891,1891,81,0,0,0
49167,application_1508364558011_4042,1,39348,39348,49167,9819,9819,208,0,0,0
49200,application_1508364558011_17995,1,47899,47899,49200,1301,1301,45,0,0,0
49215,application_1508364558011_13343,2,44393,44393,49215,4822,4822,14,0,0,0
49216,application_1508364558011_13111,2,44107,44107,49216,5109,5109,16,0,0,0
49232,application_1508364558011_18059,1,47907,47907,49232,1325,1325,48,0,0,0
49232,application_1508364558011_13371,2,44453,44453,49232,4779,4779,13,0,0,0
49252,application_1508364558011_16990,1,47157,47157,49252,2095,2095,34,0,0,0
49276,application_1508364558011_17864,1,47857,47857,49276,1419,1419,22,0,0,0
49286,application_1508364558011_15537,1,45847,45847,49286,3439,3439,55,0,0,0
49296,application_1508364558011_15921,1,46256,46256,49296,3040,3040,63,0,0,0
49296,application_1508364558011_13445,1,44546,44546,49296,4750,4750,71,0,0,0
49296,application_1508364558011_14389,1,45014,45014,49296,4282,4282,167,0,0,0
49306,application_1508364558011_18524,1,47989,47989,49306,1317,1317,73,0,0,0
49356,application_1508364558011_18247,1,47931,47931,49356,1425,1425,54,0,0,0
49386,application_1506638472019_10516,1,18551,18551,49386,30835,30835,1197,0,0,0
49406,application_1506638472019_3497,1,13435,13435,49406,35971,35971,2629,0,0,0
49444,application_1508364558011_17972,1,47896,47896,49444,1548,1548,43,0,0,0
49444,application_1508364558011_16919,1,47046,47046,49444,2398,2398,68,0,0,0
49464,application_1506638472019_37936,1,36046,36046,49464,13418,13418,358,0,0,0
49474,application_1508364558011_18507,1,47987,47987,49474,1487,1487,52,0,0,0
49481,application_1508364558011_16901,1,47006,47006,49481,2475,2475,67,0,0,0
49481,application_1508364558011_18503,1,47986,47986,49481,1495,1495,57,0,0,0
49501,application_1508364558011_17986,1,47897,47897,49501,1604,1604,49,0,0,0
49506,application_1506638472019_11100,1,18674,18674,49506,30832,30832,1452,0,0,0
49536,application_1506638472019_3200,1,13376,13376,49536,36160,36160,2530,0,0,0
49536,application_1506638472019_36976,1,35528,35528,49536,14008,14008,466,0,0,0
49546,application_1508364558011_18415,1,47948,47948,49546,1598,1598,53,0,0,0
49556,application_1508364558011_17017,1,47196,47196,49556,2360,2360,72,0,0,0
49573,application_1506638472019_11951,1,18799,18799,49573,30774,30774,1493,0,0,0
49606,application_1506638472019_37739,1,35978,35978,49606,13628,13628,434,0,0,0
49616,application_1506638472019_10940,1,18658,18658,49616,30958,30958,1511,0,0,0
49616,application_1506638472019_10313,1,18282,18282,49616,31334,31334,1557,0,0,0
49626,application_1506638472019_2804,1,13311,13311,49626,36315,36315,2668,0,0,0
49673,application_1508364558011_17956,1,47894,47894,49673,1779,1779,56,0,0,0
49703,application_1508364558011_16890,1,46986,46986,49703,2717,2717,65,0,0,0
49713,application_1508364558011_16823,1,46816,46816,49713,2897,2897,82,0,0,0
49733,application_1506638472019_38763,1,36729,36729,49733,13004,13004,518,0,0,0
49756,application_1508364558011_13866,2,44704,44704,49756,5052,5052,496,0,0,0
49776,application_1508364558011_18114,1,47915,47915,49776,1861,1861,49,0,0,0
49806,application_1508364558011_18077,1,47910,47910,49806,1896,1896,43,0,0,0
49816,application_1508364558011_18084,1,47911,47911,49816,1905,1905,58,0,0,0
49816,application_1506638472019_24385,1,27613,27613,49816,22203,22203,903,0,0,0
49836,application_1506638472019_11327,1,18711,18711,49836,31125,31125,1492,0,0,0
49846,application_1508364558011_18297,1,47938,47938,49846,1908,1908,53,0,0,0
49856,application_1508364558011_18368,1,47946,47946,49856,1910,1910,68,0,0,0
49874,application_1508364558011_13184,1,44165,44165,49874,5709,5709,124,0,0,0
49874,application_1506638472019_4418,1,15373,15373,49874,34501,34501,1838,0,0,0
49890,application_1508364558011_18291,1,47937,47937,49890,1953,1953,57,0,0,0
49902,application_1508364558011_18082,1,47910,47910,49902,1992,1992,51,0,0,0
49946,application_1508364558011_13338,1,44386,44386,49946,5560,5560,111,0,0,0
49977,application_1508364558011_18051,1,47906,47906,49977,2071,2071,51,0,0,0
49977,application_1506638472019_10935,1,18658,18658,49977,31319,31319,1559,0,0,0
49997,application_1506638472019_24513,1,27696,27696,49997,22301,22301,662,0,0,0
50043,application_1506638472019_11085,1,18673,18673,50043,31370,31370,1427,0,0,0
50043,application_1506638472019_24961,1,27767,27767,50043,22276,22276,696,0,0,0
50073,application_1508364558011_17882,1,47872,47872,50073,2201,2201,44,0,0,0
50146,application_1508364558011_18359,1,47945,47945,50146,2201,2201,49,0,0,0
50147,application_1508364558011_18336,1,47943,47943,50147,2204,2204,55,0,0,0
50157,application_1508364558011_18040,1,47905,47905,50157,2252,2252,55,0,0,0
50202,application_1508364558011_18136,1,47918,47918,50202,2284,2284,50,0,0,0
50212,application_1508364558011_18186,1,47924,47924,50212,2288,2288,73,0,0,0
50222,application_1508364558011_17949,1,47893,47893,50222,2329,2329,49,0,0,0
50232,application_1508364558011_18511,1,47987,47987,50232,2245,2245,49,0,0,0
50232,application_1508364558011_18515,1,47988,47988,50232,2244,2244,66,0,0,0
50246,application_1508364558011_18005,1,47901,47901,50246,2345,2345,63,0,0,0
50264,application_1506638472019_37695,1,35975,35975,50264,14289,14289,453,0,0,0
50264,application_1506638472019_10842,1,18649,18649,50264,31615,31615,1450,0,0,0
50265,application_1508364558011_18246,1,47931,47931,50265,2334,2334,64,0,0,0
50288,application_1508364558011_16846,1,46886,46886,50288,3402,3402,72,0,0,0
50288,application_1508364558011_17971,1,47896,47896,50288,2392,2392,58,0,0,0
50298,application_1506638472019_11743,1,18777,18777,50298,31521,31521,1579,0,0,0
50308,application_1508364558011_17951,1,47893,47893,50308,2415,2415,70,0,0,0
50368,application_1508364558011_15595,1,45926,45926,50368,4442,4442,74,0,0,0
50417,application_1506638472019_37917,1,36039,36039,50417,14378,14378,362,0,0,0
50417,application_1508364558011_18578,1,47996,47996,50417,2421,2421,76,0,0,0
50466,application_1508364558011_14493,1,45096,45096,50466,5370,5370,113,0,0,0
50486,application_1508364558011_1259,1,38477,38477,50486,12009,12009,208,0,0,0
50510,application_1506638472019_12052,1,18811,18811,50510,31699,31699,1555,0,0,0
50520,application_1506638472019_2713,1,13304,13304,50520,37216,37216,2548,0,0,0
50546,application_1508364558011_18295,1,47937,47937,50546,2609,2609,73,0,0,0
50556,application_1508364558011_19969,1,49216,49216,50556,1340,1340,71,0,0,0
50556,application_1508364558011_13950,2,44836,44836,50556,5720,5720,35,0,0,0
50575,application_1508364558011_20311,1,49481,49481,50575,1094,1094,14,0,0,0
50581,application_1508364558011_19817,1,49203,49203,50581,1378,1378,55,0,0,0
50592,application_1508364558011_17717,1,47736,47736,50592,2856,2856,63,0,0,0
50622,application_1506638472019_10809,1,18646,18646,50622,31976,31976,1466,0,0,0
50649,application_1506638472019_32614,4,33362,33362,50649,17287,17287,69,0,0,0
50659,application_1508364558011_18604,1,48001,48001,50659,2658,2658,49,0,0,0
50672,application_1506638472019_2858,1,13314,13314,50672,37358,37358,2428,0,0,0
50703,application_1508364558011_19807,1,49202,49202,50703,1501,1501,54,0,0,0
50713,application_1506638472019_32617,4,33362,33362,50713,17351,17351,55,0,0,0
50723,application_1506638472019_11879,1,18790,18790,50723,31933,31933,1426,0,0,0
50752,application_1508364558011_9232,1,41966,41966,50752,8786,8786,138,0,0,0
50752,application_1506638472019_11810,1,18783,18783,50752,31969,31969,1496,0,0,0
50781,application_1508364558011_16879,1,46966,46966,50781,3815,3815,60,0,0,0
50811,application_1508364558011_19606,1,48996,48996,50811,1815,1815,58,0,0,0
50816,application_1508364558011_18080,1,47910,47910,50816,2906,2906,39,0,0,0
50826,application_1508364558011_18618,1,48003,48003,50826,2823,2823,51,0,0,0
50851,application_1508364558011_17780,1,47786,47786,50851,3065,3065,91,0,0,0
50898,application_1508364558011_18540,1,47991,47991,50898,2907,2907,59,0,0,0
50898,application_1508364558011_18739,1,48016,48016,50898,2882,2882,65,0,0,0
50918,application_1508364558011_18598,1,48000,48000,50918,2918,2918,48,0,0,0
50927,application_1508364558011_18213,1,47927,47927,50927,3000,3000,65,0,0,0
50930,application_1506638472019_3074,1,13366,13366,50930,37564,37564,2489,0,0,0
50930,application_1506638472019_32894,4,33594,33594,50930,17336,17336,217,0,0,0
50936,application_1508364558011_18576,1,47996,47996,50936,2940,2940,114,0,0,0
50956,application_1508364558011_15674,1,46010,46010,50956,4946,4946,175,0,0,0
50969,application_1508364558011_2736,1,39066,39066,50969,11903,11903,330,0,0,0
51012,application_1508364558011_18548,1,47993,47993,51012,3019,3019,54,0,0,0
51046,application_1506638472019_3410,1,13428,13428,51046,37618,37618,2381,0,0,0
51066,application_1508364558011_14471,1,45034,45034,51066,6032,6032,160,0,0,0
51076,application_1508364558011_18250,1,47932,47932,51076,3144,3144,54,0,0,0
51086,application_1506638472019_11830,1,18785,18785,51086,32301,32301,1444,0,0,0
51096,application_1506638472019_36950,1,35504,35504,51096,15592,15592,457,0,0,0
51106,application_1508364558011_18101,1,47913,47913,51106,3193,3193,73,0,0,0
51126,application_1506638472019_1751,4,10413,10413,51126,40713,40713,5125,0,0,0
51176,application_1508364558011_18313,1,47939,47939,51176,3237,3237,63,0,0,0
51196,application_1508364558011_18191,1,47925,47925,51196,3271,3271,48,0,0,0
51236,application_1506638472019_10693,1,18632,18632,51236,32604,32604,1449,0,0,0
51276,application_1508364558011_15605,1,45956,45956,51276,5320,5320,139,0,0,0
51286,application_1506638472019_25049,1,27778,27778,51286,23508,23508,702,0,0,0
51296,application_1508364558011_13341,1,44387,44387,51296,6909,6909,179,0,0,0
51306,application_1508364558011_17742,1,47761,47761,51306,3545,3545,77,0,0,0
51316,application_1508364558011_15553,1,45871,45871,51316,5445,5445,175,0,0,0
51335,application_1508364558011_18581,1,47997,47997,51335,3338,3338,38,0,0,0
51355,application_1508364558011_15924,1,46266,46266,51355,5089,5089,68,0,0,0
51365,application_1508364558011_17884,1,47873,47873,51365,3492,3492,59,0,0,0
51365,application_1508364558011_18173,1,47922,47922,51365,3443,3443,79,0,0,0
51376,application_1508364558011_17820,1,47822,47822,51376,3554,3554,85,0,0,0
51396,application_1506638472019_3111,1,13369,13369,51396,38027,38027,2744,0,0,0
51406,application_1506638472019_11671,1,18759,18759,51406,32647,32647,1507,0,0,0
51416,application_1508364558011_17705,1,47706,47706,51416,3710,3710,68,0,0,0
51436,application_1506638472019_2820,1,13312,13312,51436,38124,38124,2665,0,0,0
51446,application_1508364558011_21181,1,50546,50546,51446,900,900,58,0,0,0
51456,application_1508364558011_19982,1,49217,49217,51456,2239,2239,73,0,0,0
51506,application_1508364558011_15488,1,45776,45776,51506,5730,5730,109,0,0,0
51516,application_1508364558011_19034,1,48326,48326,51516,3190,3190,80,0,0,0
51546,application_1508364558011_17832,1,47831,47831,51546,3715,3715,113,0,0,0
51546,application_1508364558011_21242,1,50577,50577,51546,969,969,75,0,0,0
51656,application_1508364558011_20509,1,49756,49756,51656,1900,1900,54,0,0,0
51676,application_1506638472019_10996,1,18664,18664,51676,33012,33012,1481,0,0,0
51726,application_1508364558011_14706,1,45247,45247,51726,6479,6479,67,0,0,0
51736,application_1508364558011_16826,1,46826,46826,51736,4910,4910,70,0,0,0
51756,application_1508364558011_1507,1,38725,38725,51756,13031,13031,348,0,0,0
51756,application_1506638472019_2810,1,13311,13311,51756,38445,38445,2398,0,0,0
51766,application_1508364558011_17768,1,47781,47781,51766,3985,3985,102,0,0,0
51796,application_1508364558011_18282,1,47936,47936,51796,3860,3860,83,0,0,0
51796,application_1508364558011_18153,1,47920,47920,51796,3876,3876,73,0,0,0
51846,application_1508364558011_18256,1,47932,47932,51846,3914,3914,54,0,0,0
51856,application_1508364558011_19352,1,48786,48786,51856,3070,3070,82,0,0,0
51906,application_1508364558011_15545,1,45863,45863,51906,6043,6043,145,0,0,0
51926,application_1508364558011_18288,1,47936,47936,51926,3990,3990,48,0,0,0
51986,application_1508364558011_18007,1,47901,47901,51986,4085,4085,53,0,0,0
51986,application_1508364558011_18572,1,47996,47996,51986,3990,3990,66,0,0,0
52026,application_1508364558011_17781,1,47786,47786,52026,4240,4240,83,0,0,0
52036,application_1508364558011_17955,1,47894,47894,52036,4142,4142,101,0,0,0
52046,application_1508364558011_20354,1,49576,49576,52046,2470,2470,57,0,0,0
52056,application_1506638472019_11041,1,18668,18668,52056,33388,33388,1495,0,0,0
52087,application_1506638472019_2864,1,13315,13315,52087,38772,38772,2869,0,0,0
52147,application_1508364558011_18125,1,47917,47917,52147,4230,4230,86,0,0,0
52157,application_1508364558011_20012,1,49220,49220,52157,2937,2937,63,0,0,0
52167,application_1506638472019_11082,1,18673,18673,52167,33494,33494,1569,0,0,0
52177,application_1508364558011_20235,1,49336,49336,52177,2841,2841,62,0,0,0
52177,application_1508364558011_20002,1,49218,49218,52177,2959,2959,65,0,0,0
52241,application_1508364558011_18630,1,48005,48005,52241,4236,4236,64,0,0,0
52251,application_1508364558011_15677,1,46010,46010,52251,6241,6241,161,0,0,0
52271,application_1508364558011_19147,1,48466,48466,52271,3805,3805,112,0,0,0
52321,application_1506638472019_11026,1,18666,18666,52321,33655,33655,1487,0,0,0
52331,application_1508364558011_18162,1,47921,47921,52331,4410,4410,88,0,0,0
52341,application_1508364558011_18202,1,47926,47926,52341,4415,4415,62,0,0,0
52376,application_1508364558011_19946,1,49215,49215,52376,3161,3161,75,0,0,0
52396,application_1508364558011_19607,1,49004,49004,52396,3392,3392,68,0,0,0
52406,application_1508364558011_18388,1,47947,47947,52406,4459,4459,98,0,0,0
52416,application_1508364558011_18330,1,47942,47942,52416,4474,4474,45,0,0,0
52476,application_1508364558011_21100,1,50466,50466,52476,2010,2010,63,0,0,0
52496,application_1508364558011_17224,1,47326,47326,52496,5170,5170,74,0,0,0
52496,application_1508364558011_18363,1,47945,47945,52496,4551,4551,116,0,0,0
52506,application_1508364558011_15722,1,46013,46013,52506,6493,6493,172,0,0,0
52516,application_1508364558011_16837,1,46865,46865,52516,5651,5651,171,0,0,0
52531,application_1508364558011_19181,1,48536,48536,52531,3995,3995,74,0,0,0
52536,application_1508364558011_20324,1,49506,49506,52536,3030,3030,66,0,0,0
52566,application_1508364558011_17769,1,47781,47781,52566,4785,4785,103,0,0,0
52586,application_1508364558011_19958,1,49216,49216,52586,3370,3370,83,0,0,0
52596,application_1508364558011_18209,1,47927,47927,52596,4669,4669,76,0,0,0
52606,application_1508364558011_14546,1,45141,45141,52606,7465,7465,138,0,0,0
52626,application_1508364558011_16727,1,46786,46786,52626,5840,5840,76,0,0,0
52626,application_1508364558011_21250,1,50578,50578,52626,2048,2048,29,0,0,0
52666,application_1508364558011_15650,1,46008,46008,52666,6658,6658,180,0,0,0
52686,application_1508364558011_18273,1,47935,47935,52686,4751,4751,79,0,0,0
52726,application_1508364558011_18266,1,47934,47934,52726,4792,4792,90,0,0,0
52736,application_1508364558011_17998,1,47900,47900,52736,4836,4836,50,0,0,0
52746,application_1506638472019_11851,1,18787,18787,52746,33959,33959,1537,0,0,0
52766,application_1508364558011_20114,1,49266,49266,52766,3500,3500,104,0,0,0
52766,application_1508364558011_17750,1,47766,47766,52766,5000,5000,139,0,0,0
52806,application_1508364558011_21662,1,50936,50936,52806,1870,1870,39,0,0,0
52806,application_1508364558011_13365,1,44435,44435,52806,8371,8371,165,0,0,0
52816,application_1508364558011_21233,1,50575,50575,52816,2241,2241,81,0,0,0
52826,application_1508364558011_17202,1,47314,47314,52826,5512,5512,136,0,0,0
52856,application_1508364558011_21326,1,50703,50703,52856,2153,2153,79,0,0,0
52856,application_1508364558011_17931,1,47883,47883,52856,4973,4973,44,0,0,0
52876,application_1508364558011_19225,1,48656,48656,52876,4220,4220,93,0,0,0
52876,application_1508364558011_18183,1,47924,47924,52876,4952,4952,104,0,0,0
52926,application_1506638472019_37664,1,35974,35974,52926,16952,16952,392,0,0,0
52946,application_1508364558011_19250,1,48746,48746,52946,4200,4200,72,0,0,0
53053,application_1506638472019_37656,1,35973,35973,53053,17080,17080,498,0,0,0
53053,application_1508364558011_20290,1,49426,49426,53053,3627,3627,68,0,0,0
53056,application_1508364558011_19796,1,49201,49201,53056,3855,3855,53,0,0,0
53076,application_1506638472019_11020,1,18666,18666,53076,34410,34410,1485,0,0,0
53086,application_1506638472019_12167,1,18823,18823,53086,34263,34263,1554,0,0,0
53096,application_1508364558011_12406,1,43574,43574,53096,9522,9522,187,0,0,0
53096,application_1508364558011_21227,1,50574,50574,53096,2522,2522,54,0,0,0
53116,application_1508364558011_17863,1,47856,47856,53116,5260,5260,89,0,0,0
53126,application_1506638472019_18207,1,24543,24543,53126,28583,28583,1184,0,0,0
53126,application_1508364558011_15694,1,46011,46011,53126,7115,7115,202,0,0,0
53136,application_1508364558011_19957,1,49216,49216,53136,3920,3920,81,0,0,0
53136,application_1506638472019_10793,1,18644,18644,53136,34492,34492,1422,0,0,0
53192,application_1508364558011_16426,1,46526,46526,53192,6666,6666,76,0,0,0
53212,application_1508364558011_21224,1,50573,50573,53212,2639,2639,74,0,0,0
53212,application_1508364558011_15955,1,46333,46333,53212,6879,6879,173,0,0,0
53247,application_1508364558011_17853,1,47846,47846,53247,5401,5401,94,0,0,0
53257,application_1506638472019_2828,1,13312,13312,53257,39945,39945,2506,0,0,0
53257,application_1506638472019_12467,1,19004,19004,53257,34253,34253,1502,0,0,0
53264,application_1506638472019_11260,1,18700,18700,53264,34564,34564,1472,0,0,0
53316,application_1508364558011_20339,1,49546,49546,53316,3770,3770,57,0,0,0
53336,application_1506638472019_11897,1,18792,18792,53336,34544,34544,1532,0,0,0
53346,application_1508364558011_1751,1,38807,38807,53346,14539,14539,399,0,0,0
53356,application_1506638472019_3119,1,13370,13370,53356,39986,39986,2891,0,0,0
53376,application_1506638472019_10822,1,18647,18647,53376,34729,34729,1476,0,0,0
53416,application_1508364558011_15459,1,45700,45700,53416,7716,7716,173,0,0,0
53426,application_1508364558011_21907,1,51696,51696,53426,1730,1730,68,0,0,0
53467,application_1506638472019_12223,1,18845,18845,53467,34622,34622,1501,0,0,0
53467,application_1506638472019_11795,1,18782,18782,53467,34685,34685,1490,0,0,0
53477,application_1508364558011_21659,1,50927,50927,53477,2550,2550,59,0,0,0
53487,application_1508364558011_18159,1,47921,47921,53487,5566,5566,66,0,0,0
53536,application_1506638472019_37658,1,35973,35973,53536,17563,17563,502,0,0,0
53566,application_1506638472019_12080,1,18814,18814,53566,34752,34752,1615,0,0,0
53576,application_1508364558011_18206,1,47926,47926,53576,5650,5650,104,0,0,0
53576,application_1506638472019_12043,1,18810,18810,53576,34766,34766,1530,0,0,0
53596,application_1506638472019_11737,1,18776,18776,53596,34820,34820,1476,0,0,0
53656,application_1508364558011_19171,1,48516,48516,53656,5140,5140,78,0,0,0
53676,application_1506638472019_3012,1,13361,13361,53676,40315,40315,2720,0,0,0
53696,application_1508364558011_21914,1,51706,51706,53696,1990,1990,66,0,0,0
53716,application_1506638472019_2780,1,13308,13308,53716,40408,40408,2664,0,0,0
53726,application_1506638472019_11072,1,18672,18672,53726,35054,35054,1439,0,0,0
53726,application_1506638472019_10929,1,18657,18657,53726,35069,35069,1531,0,0,0
53766,application_1508364558011_10774,1,42409,42409,53766,11357,11357,243,0,0,0
53797,application_1508364558011_20018,1,49222,49222,53797,4575,4575,98,0,0,0
53797,application_1508364558011_20278,1,49396,49396,53797,4401,4401,73,0,0,0
53797,application_1508364558011_21726,1,51186,51186,53797,2611,2611,59,0,0,0
53817,application_1508364558011_21750,1,51316,51316,53817,2501,2501,56,0,0,0
53827,application_1506638472019_11047,1,18669,18669,53827,35158,35158,1505,0,0,0
53827,application_1508364558011_20884,1,50236,50236,53827,3591,3591,72,0,0,0
53856,application_1506638472019_2924,1,13319,13319,53856,40537,40537,2721,0,0,0
53866,application_1508364558011_21693,1,50992,50992,53866,2874,2874,60,0,0,0
53886,application_1506638472019_10828,1,18648,18648,53886,35238,35238,1419,0,0,0
53916,application_1508364558011_21264,1,50582,50582,53916,3334,3334,100,0,0,0
53936,application_1508364558011_21214,1,50571,50571,53936,3365,3365,81,0,0,0
53986,application_1508364558011_20606,1,49886,49886,53986,4100,4100,87,0,0,0
53986,application_1506638472019_3534,1,13438,13438,53986,40548,40548,2722,0,0,0
54006,application_1506638472019_38785,1,36730,36730,54006,17276,17276,537,0,0,0
54016,application_1506638472019_6183,4,16795,16795,54016,37221,37221,4279,0,0,0
54056,application_1508364558011_21087,1,50436,50436,54056,3620,3620,75,0,0,0
54066,application_1508364558011_15703,1,46012,46012,54066,8054,8054,188,0,0,0
54086,application_1508364558011_2644,1,39045,39045,54086,15041,15041,360,0,0,0
54156,application_1508364558011_21986,1,51976,51976,54156,2180,2180,64,0,0,0
54166,application_1506638472019_3269,1,13380,13380,54166,40786,40786,2813,0,0,0
54166,application_1506638472019_12119,1,18817,18817,54166,35349,35349,1443,0,0,0
54186,application_1506638472019_12090,1,18814,18814,54186,35372,35372,1526,0,0,0
54186,application_1506638472019_10903,1,18655,18655,54186,35531,35531,1498,0,0,0
54211,application_1506638472019_10715,1,18635,18635,54211,35576,35576,1490,0,0,0
54231,application_1506638472019_11113,1,18675,18675,54231,35556,35556,1441,0,0,0
54231,application_1506638472019_3132,1,13370,13370,54231,40861,40861,2688,0,0,0
54270,application_1508364558011_21992,1,51996,51996,54270,2274,2274,58,0,0,0
54270,application_1508364558011_21262,1,50581,50581,54270,3689,3689,72,0,0,0
54279,application_1506638472019_3022,1,13362,13362,54279,40917,40917,2594,0,0,0
54279,application_1508364558011_17018,1,47202,47202,54279,7077,7077,144,0,0,0
54298,application_1508364558011_22245,1,53276,53276,54298,1022,1022,58,0,0,0
54298,application_1508364558011_19227,1,48666,48666,54298,5632,5632,66,0,0,0
54325,application_1506638472019_3297,1,13383,13383,54325,40942,40942,2727,0,0,0
54336,application_1506638472019_11966,1,18801,18801,54336,35535,35535,1441,0,0,0
54356,application_1506638472019_37704,1,35976,35976,54356,18380,18380,486,0,0,0
54366,application_1508364558011_20634,1,49906,49906,54366,4460,4460,69,0,0,0
54386,application_1508364558011_21587,1,50826,50826,54386,3560,3560,130,0,0,0
54386,application_1506638472019_11955,1,18800,18800,54386,35586,35586,1438,0,0,0
54396,application_1508364558011_18052,1,47906,47906,54396,6490,6490,170,0,0,0
54426,application_1508364558011_19773,1,49200,49200,54426,5226,5226,83,0,0,0
54469,application_1508364558011_22167,1,52916,52916,54469,1553,1553,85,0,0,0
54479,application_1508364558011_18146,1,47919,47919,54479,6560,6560,62,0,0,0
54486,application_1508364558011_21813,1,51626,51626,54486,2860,2860,79,0,0,0
54496,application_1508364558011_21707,1,51056,51056,54496,3440,3440,74,0,0,0
54513,application_1506638472019_10917,1,18656,18656,54513,35857,35857,1511,0,0,0
54549,application_1506638472019_2775,1,13308,13308,54549,41241,41241,2697,0,0,0
54569,application_1508364558011_18109,1,47914,47914,54569,6655,6655,88,0,0,0
54594,application_1508364558011_22166,1,52906,52906,54594,1688,1688,69,0,0,0
54594,application_1508364558011_2221,1,39001,39001,54594,15593,15593,558,0,0,0
54636,application_1508364558011_21797,1,51566,51566,54636,3070,3070,56,0,0,0
54636,application_1508364558011_22261,1,53326,53326,54636,1310,1310,69,0,0,0
54656,application_1506638472019_20364,1,25702,25702,54656,28954,28954,872,0,0,0
54676,application_1508364558011_21317,1,50676,50676,54676,4000,4000,73,0,0,0
54686,application_1508364558011_21660,1,50930,50930,54686,3756,3756,48,0,0,0
54706,application_1506638472019_10679,1,18630,18630,54706,36076,36076,1452,0,0,0
54716,application_1506638472019_2636,1,13295,13295,54716,41421,41421,2758,0,0,0
54716,application_1508364558011_22161,1,52876,52876,54716,1840,1840,69,0,0,0
54733,application_1508364558011_21663,1,50936,50936,54733,3797,3797,77,0,0,0
54743,application_1508364558011_21305,1,50649,50649,54743,4094,4094,96,0,0,0
54826,application_1508364558011_21949,1,51796,51796,54826,3030,3030,79,0,0,0
54886,application_1508364558011_21258,1,50580,50580,54886,4306,4306,76,0,0,0
54896,application_1508364558011_15422,1,45637,45637,54896,9259,9259,195,0,0,0
54896,application_1508364558011_22363,1,53576,53576,54896,1320,1320,57,0,0,0
54928,application_1508364558011_22174,1,52956,52956,54928,1972,1972,62,0,0,0
54978,application_1506638472019_10694,1,18632,18632,54978,36346,36346,1449,0,0,0
54978,application_1508364558011_22109,1,52606,52606,54978,2372,2372,84,0,0,0
54988,application_1508364558011_17874,1,47861,47861,54988,7127,7127,83,0,0,0
54988,application_1506638472019_10894,1,18654,18654,54988,36334,36334,1583,0,0,0
54988,application_1506638472019_3212,1,13376,13376,54988,41612,41612,2383,0,0,0
54998,application_1508364558011_22101,1,52536,52536,54998,2462,2462,77,0,0,0
54998,application_1506638472019_3521,1,13437,13437,54998,41561,41561,2595,0,0,0
55008,application_1508364558011_15735,1,46014,46014,55008,8994,8994,184,0,0,0
55058,application_1508364558011_22204,1,53116,53116,55058,1942,1942,60,0,0,0
55088,application_1506638472019_38809,1,36733,36733,55088,18355,18355,592,0,0,0
55160,application_1508364558011_21762,1,51366,51366,55160,3794,3794,61,0,0,0
55170,application_1508364558011_22297,1,53396,53396,55170,1774,1774,72,0,0,0
55170,application_1508364558011_1044,1,38236,38236,55170,16934,16934,589,0,0,0
55170,application_1508364558011_17763,1,47781,47781,55170,7389,7389,179,0,0,0
55276,application_1508364558011_21323,1,50697,50697,55276,4579,4579,77,0,0,0
55316,application_1508364558011_22157,1,52856,52856,55316,2460,2460,60,0,0,0
55356,application_1506638472019_2970,1,13323,13323,55356,42033,42033,2552,0,0,0
55376,application_1508364558011_20482,16,49673,49673,55376,5703,5703,288,0,0,0
55396,application_1506638472019_10769,1,18640,18640,55396,36756,36756,1448,0,0,0
55416,application_1508364558011_21299,1,50647,50647,55416,4769,4769,70,0,0,0
55427,application_1508364558011_19802,1,49202,49202,55427,6225,6225,86,0,0,0
55437,application_1506638472019_3633,1,13534,13534,55437,41903,41903,2575,0,0,0
55496,application_1508364558011_22789,1,54576,54576,55496,920,920,43,0,0,0
55566,application_1508364558011_13395,1,44478,44478,55566,11088,11088,358,0,0,0
55596,application_1506638472019_12175,1,18824,18824,55596,36772,36772,1475,0,0,0
55606,application_1508364558011_22076,1,52356,52356,55606,3250,3250,71,0,0,0
55606,application_1506638472019_10676,1,18630,18630,55606,36976,36976,1509,0,0,0
55616,application_1506638472019_10775,1,18641,18641,55616,36975,36975,1502,0,0,0
55626,application_1506638472019_12240,1,18848,18848,55626,36778,36778,1590,0,0,0
55636,application_1506638472019_11829,1,18785,18785,55636,36851,36851,1474,0,0,0
55666,application_1508364558011_5303,1,39868,39868,55666,15798,15798,486,0,0,0
55676,application_1508364558011_21742,1,51286,51286,55676,4390,4390,136,0,0,0
55689,application_1508364558011_18028,1,47903,47903,55689,7786,7786,116,0,0,0
55689,application_1508364558011_21205,1,50568,50568,55689,5121,5121,112,0,0,0
55699,application_1508364558011_15663,1,46009,46009,55699,9690,9690,215,0,0,0
55779,application_1506638472019_11710,1,18773,18773,55779,37006,37006,1496,0,0,0
55779,application_1508364558011_21219,1,50572,50572,55779,5207,5207,96,0,0,0
55809,application_1508364558011_17859,1,47849,47849,55809,7960,7960,134,0,0,0
55829,application_1506638472019_2808,1,13311,13311,55829,42518,42518,2494,0,0,0
55880,application_1508364558011_15548,2,45865,45865,55880,10015,10015,12,0,0,0
55880,application_1508364558011_15943,2,46312,46312,55880,9568,9568,16,0,0,0
55900,application_1508364558011_16590,2,46673,46673,55900,9227,9227,15,0,0,0
55946,application_1508364558011_21724,1,51166,51166,55946,4780,4780,87,0,0,0
56037,application_1506638472019_11857,1,18788,18788,56037,37249,37249,1465,0,0,0
56047,application_1508364558011_21232,1,50575,50575,56047,5472,5472,75,0,0,0
56094,application_1508364558011_22110,1,52616,52616,56094,3478,3478,65,0,0,0
56141,application_1508364558011_22497,1,54156,54156,56141,1985,1985,77,0,0,0
56211,application_1506638472019_4034,1,14318,14318,56211,41893,41893,2427,0,0,0
56231,application_1508364558011_21618,1,50851,50851,56231,5380,5380,92,0,0,0
56231,application_1508364558011_22460,1,53966,53966,56231,2265,2265,77,0,0,0
56261,application_1506638472019_10755,1,18639,18639,56261,37622,37622,1552,0,0,0
56321,application_1508364558011_22404,1,53746,53746,56321,2575,2575,66,0,0,0
56361,application_1508364558011_22338,1,53536,53536,56361,2825,2825,63,0,0,0
56391,application_1506638472019_2909,1,13318,13318,56391,43073,43073,2750,0,0,0
56401,application_1506638472019_11067,1,18671,18671,56401,37730,37730,1532,0,0,0
56401,application_1508364558011_21778,1,51466,51466,56401,4935,4935,62,0,0,0
56411,application_1508364558011_22430,1,53836,53836,56411,2575,2575,84,0,0,0
56411,application_1508364558011_22201,1,53106,53106,56411,3305,3305,74,0,0,0
56418,application_1508364558011_22555,1,54279,54279,56418,2139,2139,75,0,0,0
56438,application_1508364558011_22194,1,53056,53056,56438,3382,3382,68,0,0,0
56458,application_1508364558011_22874,1,54766,54766,56458,1692,1692,60,0,0,0
56468,application_1508364558011_22445,1,53906,53906,56468,2562,2562,58,0,0,0
56526,application_1508364558011_15853,1,46176,46176,56526,10350,10350,234,0,0,0
56546,application_1508364558011_22466,1,54006,54006,56546,2540,2540,67,0,0,0
56586,application_1508364558011_22751,1,54525,54525,56586,2061,2061,60,0,0,0
56596,application_1508364558011_22861,1,54723,54723,56596,1873,1873,53,0,0,0
56596,application_1508364558011_17494,2,47491,47491,56596,9105,9105,674,0,0,0
56746,application_1506638472019_10716,1,18635,18635,56746,38111,38111,1495,0,0,0
56878,application_1506638472019_10984,1,18663,18663,56878,38215,38215,1483,0,0,0
56878,application_1508364558011_22858,1,54723,54723,56878,2155,2155,53,0,0,0
56888,application_1508364558011_23006,1,55196,55196,56888,1692,1692,59,0,0,0
56888,application_1508364558011_20762,1,50013,50013,56888,6875,6875,104,0,0,0
56996,application_1508364558011_22275,1,53366,53366,56996,3630,3630,65,0,0,0
57026,application_1508364558011_15639,1,46007,46007,57026,11019,11019,184,0,0,0
57046,application_1508364558011_23164,1,55789,55789,57046,1257,1257,22,0,0,0
57056,application_1506638472019_12133,1,18818,18818,57056,38238,38238,1468,0,0,0
57066,application_1508364558011_4474,1,39424,39424,57066,17642,17642,465,0,0,0
57106,application_1506638472019_38647,1,36490,36490,57106,20616,20616,585,0,0,0
57116,application_1508364558011_22467,1,54016,54016,57116,3100,3100,71,0,0,0
57196,application_1508364558011_4726,1,39804,39804,57196,17392,17392,508,0,0,0
57206,application_1506638472019_10833,1,18648,18648,57206,38558,38558,1530,0,0,0
57246,application_1508364558011_22581,1,54298,54298,57246,2948,2948,110,0,0,0
57246,application_1506638472019_29000,1,29324,29324,57246,27922,27922,826,0,0,0
57256,application_1508364558011_22173,1,52946,52946,57256,4310,4310,61,0,0,0
57266,application_1508364558011_3886,1,39296,39296,57266,17970,17970,559,0,0,0
57276,application_1508364558011_7930,1,41599,41599,57276,15677,15677,442,0,0,0
57309,application_1508364558011_3889,1,39296,39296,57309,18013,18013,460,0,0,0
57330,application_1506638472019_3402,1,13427,13427,57330,43903,43903,2644,0,0,0
57374,application_1508364558011_3982,1,39299,39299,57374,18075,18075,545,0,0,0
57397,application_1506638472019_32702,8,33428,33428,57397,23969,23969,37,0,0,0
57400,application_1508364558011_22506,1,54206,54206,57400,3194,3194,67,0,0,0
57414,application_1506638472019_3091,1,13367,13367,57414,44047,44047,2639,0,0,0
57430,application_1508364558011_22143,1,52806,52806,57430,4624,4624,64,0,0,0
57436,application_1506638472019_12135,1,18819,18819,57436,38617,38617,1454,0,0,0
57448,application_1506638472019_3228,1,13377,13377,57448,44071,44071,2550,0,0,0
57489,application_1508364558011_10918,2,42808,42808,57489,14681,14681,27,0,0,0
57507,application_1508364558011_19473,2,48901,48901,57507,8606,8606,14,0,0,0
57525,application_1508364558011_19629,2,49075,49075,57525,8450,8450,17,0,0,0
57546,application_1508364558011_19729,2,49117,49117,57546,8429,8429,20,0,0,0
57578,application_1508364558011_1953,1,38855,38855,57578,18723,18723,444,0,0,0
57686,application_1506638472019_28253,1,29130,29130,57686,28556,28556,877,0,0,0
57756,application_1508364558011_22399,1,53716,53716,57756,4040,4040,68,0,0,0
57786,application_1506638472019_11752,1,18778,18778,57786,39008,39008,1484,0,0,0
57786,application_1508364558011_22894,1,54826,54826,57786,2960,2960,113,0,0,0
57816,application_1508364558011_22985,1,55126,55126,57816,2690,2690,79,0,0,0
57826,application_1508364558011_14174,1,44933,44933,57826,12893,12893,263,0,0,0
57836,application_1508364558011_23021,1,55286,55286,57836,2550,2550,56,0,0,0
57983,application_1508364558011_22783,1,54575,54575,57983,3408,3408,58,0,0,0
57993,application_1508364558011_25025,1,57408,57408,57993,585,585,52,0,0,0
57993,application_1506638472019_10997,1,18664,18664,57993,39329,39329,1452,0,0,0
58016,application_1508364558011_8590,1,41644,41644,58016,16372,16372,470,0,0,0
58036,application_1508364558011_22529,1,54250,54250,58036,3786,3786,121,0,0,0
58046,application_1506638472019_2795,1,13310,13310,58046,44736,44736,2756,0,0,0
58094,application_1508364558011_22695,1,54459,54459,58094,3635,3635,76,0,0,0
58094,application_1508364558011_25129,1,57422,57422,58094,672,672,40,0,0,0
58107,application_1508364558011_8316,1,41627,41627,58107,16480,16480,476,0,0,0
58136,application_1508364558011_25217,1,57431,57431,58136,705,705,53,0,0,0
58207,application_1506638472019_38779,1,36730,36730,58207,21477,21477,601,0,0,0
58247,application_1508364558011_12692,1,43616,43616,58247,14631,14631,328,0,0,0
58260,application_1508364558011_22891,1,54796,54796,58260,3464,3464,66,0,0,0
58305,application_1508364558011_23056,1,55446,55446,58305,2859,2859,77,0,0,0
58366,application_1508364558011_22247,1,53286,53286,58366,5080,5080,80,0,0,0
58396,application_1508364558011_19450,1,48836,48836,58396,9560,9560,79,0,0,0
58416,application_1506638472019_8802,1,17539,17539,58416,40877,40877,1747,0,0,0
58436,application_1506638472019_12257,1,18851,18851,58436,39585,39585,1579,0,0,0
58476,application_1508364558011_25172,1,57428,57428,58476,1048,1048,39,0,0,0
58486,application_1506638472019_37105,1,35549,35549,58486,22937,22937,544,0,0,0
58506,application_1508364558011_2473,1,39015,39015,58506,19491,19491,561,0,0,0
58513,application_1508364558011_23001,1,55176,55176,58513,3337,3337,77,0,0,0
58520,application_1508364558011_24299,1,56586,56586,58520,1934,1934,68,0,0,0
58579,application_1508364558011_25484,1,57507,57507,58579,1072,1072,47,0,0,0
58579,application_1508364558011_24912,1,57394,57394,58579,1185,1185,44,0,0,0
58622,application_1506638472019_12127,1,18818,18818,58622,39804,39804,1483,0,0,0
58622,application_1508364558011_24331,1,56676,56676,58622,1946,1946,68,0,0,0
58622,application_1508364558011_25128,1,57421,57421,58622,1201,1201,61,0,0,0
58666,application_1508364558011_12077,1,43471,43471,58666,15195,15195,571,0,0,0
58699,application_1508364558011_21952,1,51816,51816,58699,6883,6883,138,0,0,0
58699,application_1508364558011_19774,1,49200,49200,58699,9499,9499,246,0,0,0
58703,application_1508364558011_24479,1,57066,57066,58703,1637,1637,61,0,0,0
58739,application_1508364558011_25431,1,57498,57498,58739,1241,1241,53,0,0,0
58759,application_1508364558011_22148,1,52826,52826,58759,5933,5933,81,0,0,0
58789,application_1508364558011_24651,1,57326,57326,58789,1463,1463,61,0,0,0
58799,application_1506638472019_4526,1,15581,15581,58799,43218,43218,2219,0,0,0
58819,application_1506638472019_11975,1,18802,18802,58819,40017,40017,1470,0,0,0
58876,application_1508364558011_25997,1,58187,58187,58876,689,689,11,0,0,0
58916,application_1508364558011_25152,1,57426,57426,58916,1490,1490,55,0,0,0
58930,application_1508364558011_25609,1,57527,57527,58930,1403,1403,37,0,0,0
58940,application_1508364558011_20295,2,49434,49434,58940,9506,9506,18,0,0,0
58950,application_1508364558011_24466,1,57006,57006,58950,1944,1944,79,0,0,0
58960,application_1508364558011_20547,2,49863,49863,58960,9097,9097,18,0,0,0
58971,application_1508364558011_25547,1,57516,57516,58971,1455,1455,50,0,0,0
58985,application_1508364558011_20566,2,49864,49864,58985,9121,9121,23,0,0,0
59013,application_1508364558011_21097,2,50454,50454,59013,8559,8559,23,0,0,0
59023,application_1508364558011_25004,1,57402,57402,59023,1621,1621,47,0,0,0
59083,application_1508364558011_23013,1,55226,55226,59083,3857,3857,63,0,0,0
59113,application_1508364558011_13394,1,44478,44478,59113,14635,14635,359,0,0,0
59113,application_1508364558011_25788,1,57869,57869,59113,1244,1244,49,0,0,0
59123,application_1508364558011_25035,1,57409,57409,59123,1714,1714,46,0,0,0
59136,application_1508364558011_23019,1,55266,55266,59136,3870,3870,67,0,0,0
59136,application_1508364558011_22617,1,54336,54336,59136,4800,4800,138,0,0,0
59156,application_1508364558011_26472,1,58880,58880,59156,276,276,37,0,0,0
59166,application_1508364558011_25107,1,57417,57417,59166,1749,1749,56,0,0,0
59197,application_1508364558011_25051,1,57411,57411,59197,1786,1786,52,0,0,0
59207,application_1508364558011_24471,1,57036,57036,59207,2171,2171,70,0,0,0
59217,application_1508364558011_25603,1,57526,57526,59217,1691,1691,38,0,0,0
59247,application_1508364558011_25488,1,57507,57507,59247,1740,1740,48,0,0,0
59296,application_1508364558011_25439,1,57499,57499,59296,1797,1797,46,0,0,0
59346,application_1506638472019_38794,1,36730,36730,59346,22616,22616,567,0,0,0
59356,application_1508364558011_25571,1,57520,57520,59356,1836,1836,49,0,0,0
59376,application_1508364558011_25150,1,57426,57426,59376,1950,1950,47,0,0,0
59386,application_1508364558011_25442,1,57499,57499,59386,1887,1887,37,0,0,0
59436,application_1508364558011_25513,1,57510,57510,59436,1926,1926,46,0,0,0
59436,application_1508364558011_5708,1,40039,40039,59436,19397,19397,552,0,0,0
59446,application_1508364558011_25131,1,57422,57422,59446,2024,2024,46,0,0,0
59456,application_1508364558011_25600,1,57525,57525,59456,1931,1931,53,0,0,0
59476,application_1506638472019_3185,1,13374,13374,59476,46102,46102,2435,0,0,0
59496,application_1508364558011_24909,1,57393,57393,59496,2103,2103,50,0,0,0
59496,application_1508364558011_25402,1,57494,57494,59496,2002,2002,60,0,0,0
59516,application_1508364558011_25652,1,57626,57626,59516,1890,1890,63,0,0,0
59546,application_1508364558011_25017,1,57405,57405,59546,2141,2141,51,0,0,0
59566,application_1508364558011_25029,1,57409,57409,59566,2157,2157,59,0,0,0
59584,application_1508364558011_25437,1,57498,57498,59584,2086,2086,55,0,0,0
59614,application_1508364558011_25536,1,57514,57514,59614,2100,2100,41,0,0,0
59624,application_1508364558011_25544,1,57515,57515,59624,2109,2109,43,0,0,0
59634,application_1508364558011_25543,1,57515,57515,59634,2119,2119,46,0,0,0
59634,application_1508364558011_25204,1,57430,57430,59634,2204,2204,48,0,0,0
59674,application_1508364558011_25233,1,57436,57436,59674,2238,2238,63,0,0,0
59696,application_1508364558011_24253,1,56506,56506,59696,3190,3190,60,0,0,0
59696,application_1508364558011_23046,1,55416,55416,59696,4280,4280,122,0,0,0
59696,application_1508364558011_25433,1,57498,57498,59696,2198,2198,59,0,0,0
59700,application_1508364558011_24286,1,56558,56558,59700,3142,3142,91,0,0,0
59710,application_1508364558011_25963,1,58107,58107,59710,1603,1603,64,0,0,0
59737,application_1508364558011_25008,1,57402,57402,59737,2335,2335,53,0,0,0
59737,application_1508364558011_22250,1,53296,53296,59737,6441,6441,139,0,0,0
59787,application_1508364558011_8203,1,41625,41625,59787,18162,18162,507,0,0,0
59807,application_1508364558011_25502,1,57509,57509,59807,2298,2298,79,0,0,0
59844,application_1508364558011_25321,1,57458,57458,59844,2386,2386,45,0,0,0
59854,application_1506638472019_3503,1,13435,13435,59854,46419,46419,2405,0,0,0
59854,application_1508364558011_23068,1,55536,55536,59854,4318,4318,58,0,0,0
59864,application_1506638472019_3257,1,13380,13380,59864,46484,46484,2703,0,0,0
59894,application_1508364558011_14159,2,44911,44911,59894,14983,14983,248,0,0,0
59904,application_1508364558011_25084,1,57414,57414,59904,2490,2490,43,0,0,0
59904,application_1508364558011_25533,1,57514,57514,59904,2390,2390,37,0,0,0
59914,application_1508364558011_25681,1,57666,57666,59914,2248,2248,68,0,0,0
59935,application_1506638472019_38741,1,36727,36727,59935,23208,23208,586,0,0,0
59935,application_1506638472019_12475,1,19005,19005,59935,40930,40930,1614,0,0,0
59945,application_1508364558011_14349,2,44985,44985,59945,14960,14960,73,0,0,0
59959,application_1506638472019_11882,1,18790,18790,59959,41169,41169,1507,0,0,0
59980,application_1508364558011_25491,1,57508,57508,59980,2472,2472,49,0,0,0
59980,application_1508364558011_21529,2,50742,50742,59980,9238,9238,35,0,0,0
59990,application_1508364558011_24541,1,57206,57206,59990,2784,2784,68,0,0,0
60009,application_1508364558011_24557,1,57256,57256,60009,2753,2753,79,0,0,0
60019,application_1508364558011_24303,1,56606,56606,60019,3413,3413,63,0,0,0
60019,application_1508364558011_24782,1,57371,57371,60019,2648,2648,49,0,0,0
60029,application_1508364558011_26482,1,58896,58896,60029,1133,1133,58,0,0,0
60097,application_1508364558011_17871,1,47860,47860,60097,12237,12237,285,0,0,0
60107,application_1506638472019_10954,1,18660,18660,60107,41447,41447,1557,0,0,0
60127,application_1508364558011_25419,1,57496,57496,60127,2631,2631,54,0,0,0
60127,application_1508364558011_23339,1,56017,56017,60127,4110,4110,182,0,0,0
60167,application_1508364558011_24237,1,56481,56481,60167,3686,3686,69,0,0,0
60187,application_1508364558011_24519,1,57176,57176,60187,3011,3011,66,0,0,0
60191,application_1508364558011_24523,1,57186,57186,60191,3005,3005,73,0,0,0
60236,application_1508364558011_15662,1,46009,46009,60236,14227,14227,209,0,0,0
60236,application_1508364558011_24942,1,57396,57396,60236,2840,2840,58,0,0,0
60334,application_1506638472019_11736,1,18776,18776,60334,41558,41558,1472,0,0,0
60341,application_1508364558011_26274,1,58689,58689,60341,1652,1652,65,0,0,0
60372,application_1508364558011_25078,1,57414,57414,60372,2958,2958,47,0,0,0
60372,application_1506638472019_3249,1,13379,13379,60372,46993,46993,2695,0,0,0
60372,application_1508364558011_25489,1,57507,57507,60372,2865,2865,50,0,0,0
60392,application_1508364558011_25353,1,57483,57483,60392,2909,2909,49,0,0,0
60392,application_1508364558011_24863,1,57386,57386,60392,3006,3006,46,0,0,0
60392,application_1508364558011_26269,1,58686,58686,60392,1706,1706,74,0,0,0
60422,application_1506638472019_17332,1,23551,23551,60422,36871,36871,1273,0,0,0
60436,application_1508364558011_24357,1,56786,56786,60436,3650,3650,89,0,0,0
60469,application_1508364558011_22743,1,54513,54513,60469,5956,5956,139,0,0,0
60483,application_1508364558011_25354,1,57484,57484,60483,2999,2999,47,0,0,0
60483,application_1508364558011_22986,1,55130,55130,60483,5353,5353,124,0,0,0
60493,application_1508364558011_22651,1,54430,54430,60493,6063,6063,129,0,0,0
60513,application_1508364558011_26473,1,58881,58881,60513,1632,1632,43,0,0,0
60533,application_1508364558011_25525,1,57513,57513,60533,3020,3020,52,0,0,0
60533,application_1508364558011_8591,1,41644,41644,60533,18889,18889,593,0,0,0
60552,application_1508364558011_22727,1,54486,54486,60552,6066,6066,57,0,0,0
60646,application_1508364558011_25193,1,57429,57429,60646,3217,3217,57,0,0,0
60656,application_1508364558011_25163,1,57427,57427,60656,3229,3229,55,0,0,0
60666,application_1508364558011_26310,1,58699,58699,60666,1967,1967,55,0,0,0
60676,application_1508364558011_26992,1,59726,59726,60676,950,950,23,0,0,0
60676,application_1506638472019_12195,1,18829,18829,60676,41847,41847,1606,0,0,0
60690,application_1506638472019_11044,1,18669,18669,60690,42021,42021,1539,0,0,0
60710,application_1506638472019_37690,1,35975,35975,60710,24735,24735,506,0,0,0
60737,application_1508364558011_26451,1,58836,58836,60737,1901,1901,58,0,0,0
60746,application_1508364558011_22092,1,52456,52456,60746,8290,8290,138,0,0,0
60746,application_1508364558011_26380,1,58714,58714,60746,2032,2032,60,0,0,0
60756,application_1508364558011_25972,1,58126,58126,60756,2630,2630,69,0,0,0
60756,application_1508364558011_26145,1,58539,58539,60756,2217,2217,61,0,0,0
60776,application_1508364558011_8700,1,41646,41646,60776,19130,19130,548,0,0,0
60776,application_1508364558011_26749,1,59346,59346,60776,1430,1430,69,0,0,0
60823,application_1508364558011_26311,1,58699,58699,60823,2124,2124,61,0,0,0
60823,application_1508364558011_15753,1,46016,46016,60823,14807,14807,293,0,0,0
60833,application_1508364558011_3902,1,39297,39297,60833,21536,21536,539,0,0,0
60841,application_1508364558011_24956,1,57397,57397,60841,3444,3444,50,0,0,0
60866,application_1508364558011_25033,1,57409,57409,60866,3457,3457,70,0,0,0
60886,application_1508364558011_24761,1,57366,57366,60886,3520,3520,66,0,0,0
60886,application_1508364558011_25969,1,58116,58116,60886,2770,2770,60,0,0,0
60886,application_1508364558011_5690,1,40038,40038,60886,20848,20848,537,0,0,0
60917,application_1508364558011_24289,1,56566,56566,60917,4351,4351,140,0,0,0
60966,application_1508364558011_24855,1,57381,57381,60966,3585,3585,59,0,0,0
60976,application_1508364558011_6668,1,40813,40813,60976,20163,20163,573,0,0,0
60976,application_1508364558011_25733,1,57766,57766,60976,3210,3210,71,0,0,0
60976,application_1508364558011_10707,1,42173,42173,60976,18803,18803,567,0,0,0
60976,application_1508364558011_25043,1,57410,57410,60976,3566,3566,49,0,0,0
61016,application_1508364558011_24878,1,57388,57388,61016,3628,3628,52,0,0,0
61026,application_1506638472019_34971,2,34662,34662,61026,26364,26364,3455,0,0,0
61066,application_1508364558011_26646,1,59172,59172,61066,1894,1894,40,0,0,0
61086,application_1508364558011_27000,1,59727,59727,61086,1359,1359,19,0,0,0
61096,application_1506638472019_39198,1,37156,37156,61096,23940,23940,617,0,0,0
61106,application_1508364558011_26376,1,58713,58713,61106,2393,2393,58,0,0,0
61136,application_1508364558011_26399,1,58719,58719,61136,2417,2417,93,0,0,0
61186,application_1508364558011_25921,1,58016,58016,61186,3170,3170,67,0,0,0
61256,application_1506638472019_3651,1,13536,13536,61256,47720,47720,2755,0,0,0
61266,application_1508364558011_25344,1,57480,57480,61266,3786,3786,50,0,0,0
61286,application_1508364558011_25617,1,57546,57546,61286,3740,3740,62,0,0,0
61376,application_1508364558011_25022,1,57406,57406,61376,3970,3970,81,0,0,0
61386,application_1508364558011_25862,1,57936,57936,61386,3450,3450,49,0,0,0
61386,application_1508364558011_5890,1,40043,40043,61386,21343,21343,613,0,0,0
61397,application_1508364558011_24897,1,57390,57390,61397,4007,4007,51,0,0,0
61431,application_1508364558011_8615,1,41645,41645,61431,19786,19786,569,0,0,0
61451,application_1508364558011_26355,1,58710,58710,61451,2741,2741,53,0,0,0
61451,application_1508364558011_25421,1,57496,57496,61451,3955,3955,47,0,0,0
61461,application_1508364558011_2032,1,38858,38858,61461,22603,22603,534,0,0,0
61481,application_1506638472019_38026,1,36090,36090,61481,25391,25391,859,0,0,0
61566,application_1508364558011_1964,1,38855,38855,61566,22711,22711,564,0,0,0
61566,application_1506638472019_12476,1,19005,19005,61566,42561,42561,1638,0,0,0
61589,application_1508364558011_26764,1,59376,59376,61589,2213,2213,58,0,0,0
61589,application_1508364558011_26113,1,58486,58486,61589,3103,3103,128,0,0,0
61599,application_1508364558011_24915,1,57394,57394,61599,4205,4205,48,0,0,0
61609,application_1508364558011_22902,1,54876,54876,61609,6733,6733,133,0,0,0
61627,application_1508364558011_26981,1,59725,59725,61627,1902,1902,37,0,0,0
61637,application_1508364558011_6687,1,40813,40813,61637,20824,20824,575,0,0,0
61647,application_1508364558011_26090,1,58446,58446,61647,3201,3201,80,0,0,0
61697,application_1508364558011_25132,1,57422,57422,61697,4275,4275,69,0,0,0
61727,application_1508364558011_7220,1,41279,41279,61727,20448,20448,656,0,0,0
61747,application_1508364558011_23037,1,55366,55366,61747,6381,6381,134,0,0,0
61797,application_1508364558011_12101,1,43472,43472,61797,18325,18325,575,0,0,0
61797,application_1508364558011_22462,1,53986,53986,61797,7811,7811,133,0,0,0
61816,application_1508364558011_25375,1,57489,57489,61816,4327,4327,41,0,0,0
61826,application_1508364558011_24187,1,56391,56391,61826,5435,5435,114,0,0,0
61857,application_1508364558011_27522,1,60796,60796,61857,1061,1061,62,0,0,0
61857,application_1508364558011_24464,1,56986,56986,61857,4871,4871,67,0,0,0
61883,application_1508364558011_24844,1,57377,57377,61883,4506,4506,63,0,0,0
61903,application_1508364558011_27418,1,60454,60454,61903,1449,1449,39,0,0,0
61903,application_1506638472019_12087,1,18814,18814,61903,43089,43089,1505,0,0,0
61922,application_1508364558011_26620,1,59126,59126,61922,2796,2796,63,0,0,0
61986,application_1508364558011_26877,1,59546,59546,61986,2440,2440,58,0,0,0
61990,application_1508364558011_26353,1,58709,58709,61990,3281,3281,67,0,0,0
62076,application_1508364558011_15640,1,46007,46007,62076,16069,16069,392,0,0,0
62096,application_1508364558011_25192,1,57429,57429,62096,4667,4667,44,0,0,0
62096,application_1508364558011_25556,1,57517,57517,62096,4579,4579,54,0,0,0
62116,application_1506638472019_22744,1,26980,26980,62116,35136,35136,988,0,0,0
62128,application_1508364558011_24737,1,57347,57347,62128,4781,4781,118,0,0,0
62128,application_1508364558011_1983,1,38856,38856,62128,23272,23272,780,0,0,0
62188,application_1508364558011_7684,1,41484,41484,62188,20704,20704,623,0,0,0
62218,application_1508364558011_6695,1,40814,40814,62218,21404,21404,493,0,0,0
62218,application_1508364558011_26644,1,59166,59166,62218,3052,3052,60,0,0,0
62238,application_1508364558011_24894,1,57390,57390,62238,4848,4848,53,0,0,0
62238,application_1506638472019_10939,1,18658,18658,62238,43580,43580,1439,0,0,0
62258,application_1508364558011_26258,1,58666,58666,62258,3592,3592,127,0,0,0
62276,application_1508364558011_27491,1,60666,60666,62276,1610,1610,82,0,0,0
62286,application_1508364558011_24738,1,57347,57347,62286,4939,4939,121,0,0,0
62296,application_1508364558011_26909,1,59584,59584,62296,2712,2712,95,0,0,0
62306,application_1506638472019_3456,1,13432,13432,62306,48874,48874,2706,0,0,0
62326,application_1508364558011_27334,1,60216,60216,62326,2110,2110,84,0,0,0
62376,application_1508364558011_27477,1,60596,60596,62376,1780,1780,61,0,0,0
62386,application_1508364558011_27529,1,60841,60841,62386,1545,1545,31,0,0,0
62396,application_1508364558011_27158,1,60057,60057,62396,2339,2339,79,0,0,0
62416,application_1508364558011_3876,1,39294,39294,62416,23122,23122,614,0,0,0
62459,application_1508364558011_27351,1,60264,60264,62459,2195,2195,42,0,0,0
62469,application_1508364558011_22591,1,54312,54312,62469,8157,8157,137,0,0,0
62489,application_1508364558011_27538,1,60856,60856,62489,1633,1633,35,0,0,0
62508,application_1508364558011_26524,1,58976,58976,62508,3532,3532,79,0,0,0
62538,application_1508364558011_26953,1,59676,59676,62538,2862,2862,68,0,0,0
62558,application_1508364558011_24508,1,57156,57156,62558,5402,5402,77,0,0,0
62558,application_1508364558011_17567,1,47628,47628,62558,14930,14930,364,0,0,0
62558,application_1506638472019_11022,1,18666,18666,62558,43892,43892,1647,0,0,0
62656,application_1508364558011_27580,1,60956,60956,62656,1700,1700,62,0,0,0
62666,application_1506638472019_12250,1,18850,18850,62666,43816,43816,1585,0,0,0
62676,application_1506638472019_35760,1,35009,35009,62676,27667,27667,817,0,0,0
62726,application_1508364558011_11539,1,43298,43298,62726,19428,19428,581,0,0,0
62766,application_1506638472019_2881,1,13316,13316,62766,49450,49450,2941,0,0,0
62796,application_1508364558011_0536,1,37630,37630,62796,25166,25166,524,0,0,0
62826,application_1506638472019_38148,1,36238,36238,62826,26588,26588,898,0,0,0
62826,application_1508364558011_25156,1,57426,57426,62826,5400,5400,225,0,0,0
62875,application_1508364558011_5814,1,40041,40041,62875,22834,22834,550,0,0,0
62905,application_1508364558011_27509,1,60746,60746,62905,2159,2159,53,0,0,0
62915,application_1508364558011_27637,1,61226,61226,62915,1689,1689,56,0,0,0
62936,application_1508364558011_27410,1,60426,60426,62936,2510,2510,74,0,0,0
62986,application_1508364558011_25197,1,57430,57430,62986,5556,5556,107,0,0,0
62996,application_1508364558011_1682,1,38782,38782,62996,24214,24214,675,0,0,0
63016,application_1508364558011_6836,1,40816,40816,63016,22200,22200,583,0,0,0
63026,application_1508364558011_24655,1,57330,57330,63026,5696,5696,79,0,0,0
63026,application_1508364558011_23297,1,55921,55921,63026,7105,7105,213,0,0,0
63046,application_1508364558011_22792,1,54584,54584,63046,8462,8462,249,0,0,0
63046,application_1506638472019_38734,1,36726,36726,63046,26320,26320,719,0,0,0
63126,application_1508364558011_24283,1,56556,56556,63126,6570,6570,162,0,0,0
63166,application_1508364558011_8589,1,41644,41644,63166,21522,21522,614,0,0,0
63176,application_1508364558011_9426,1,42064,42064,63176,21112,21112,617,0,0,0
63176,application_1508364558011_24354,1,56756,56756,63176,6420,6420,104,0,0,0
63203,application_1508364558011_27492,1,60676,60676,63203,2527,2527,56,0,0,0
63233,application_1508364558011_26330,1,58703,58703,63233,4530,4530,58,0,0,0
63246,application_1508364558011_26501,1,58919,58919,63246,4327,4327,100,0,0,0
63276,application_1508364558011_27810,1,61806,61806,63276,1470,1470,63,0,0,0
63276,application_1508364558011_15344,1,45569,45569,63276,17707,17707,457,0,0,0
63346,application_1508364558011_27728,1,61496,61496,63346,1850,1850,54,0,0,0
63346,application_1508364558011_27618,1,61146,61146,63346,2200,2200,63,0,0,0
63356,application_1508364558011_10667,1,42171,42171,63356,21185,21185,653,0,0,0
63386,application_1508364558011_25778,1,57856,57856,63386,5530,5530,83,0,0,0
63406,application_1506638472019_3430,1,13429,13429,63406,49977,49977,2704,0,0,0
63426,application_1504131676014_22283,1,5126,5126,63426,58300,58300,7790,0,0,0
63476,application_1508364558011_27992,1,62436,62436,63476,1040,1040,52,0,0,0
63506,application_1506638472019_24061,1,27333,27333,63506,36173,36173,1229,0,0,0
63516,application_1508364558011_25739,1,57776,57776,63516,5740,5740,193,0,0,0
63546,application_1508364558011_26021,1,58250,58250,63546,5296,5296,106,0,0,0
63556,application_1508364558011_26060,1,58336,58336,63556,5220,5220,108,0,0,0
63556,application_1508364558011_5684,1,40038,40038,63556,23518,23518,511,0,0,0
63566,application_1508364558011_4761,1,39805,39805,63566,23761,23761,602,0,0,0
63576,application_1508364558011_6756,1,40814,40814,63576,22762,22762,523,0,0,0
63621,application_1508364558011_15171,1,45566,45566,63621,18055,18055,608,0,0,0
63631,application_1506638472019_37694,1,35975,35975,63631,27656,27656,712,0,0,0
63681,application_1508364558011_27971,1,62355,62355,63681,1326,1326,47,0,0,0
63691,application_1508364558011_27898,1,62066,62066,63691,1625,1625,61,0,0,0
63746,application_1508364558011_10323,1,42148,42148,63746,21598,21598,640,0,0,0
63796,application_1508364558011_8684,1,41646,41646,63796,22150,22150,666,0,0,0
63816,application_1508364558011_4878,1,39809,39809,63816,24007,24007,533,0,0,0
63818,application_1508364558011_11949,1,43450,43450,63818,20368,20368,497,0,0,0
63868,application_1506638472019_2786,1,13309,13309,63868,50559,50559,2855,0,0,0
63886,application_1506638472019_38772,1,36729,36729,63886,27157,27157,670,0,0,0
63895,application_1506638472019_20067,1,25141,25141,63895,38754,38754,1284,0,0,0
63926,application_1508364558011_27495,1,60690,60690,63926,3236,3236,67,0,0,0
63936,application_1508364558011_25806,1,57876,57876,63936,6060,6060,147,0,0,0
63936,application_1508364558011_27515,1,60766,60766,63936,3170,3170,71,0,0,0
63956,application_1506638472019_11152,1,18680,18680,63956,45276,45276,1756,0,0,0
64006,application_1508364558011_6722,1,40814,40814,64006,23192,23192,620,0,0,0
64016,application_1506638472019_38754,1,36728,36728,64016,27288,27288,608,0,0,0
64045,application_1508364558011_26794,1,59426,59426,64045,4619,4619,56,0,0,0
64065,application_1508364558011_27879,1,62016,62016,64065,2049,2049,63,0,0,0
64115,application_1508364558011_27669,1,61306,61306,64115,2809,2809,67,0,0,0
64126,application_1508364558011_26701,1,59286,59286,64126,4840,4840,131,0,0,0
64146,application_1508364558011_28118,1,63076,63076,64146,1070,1070,69,0,0,0
64216,application_1508364558011_28020,1,62586,62586,64216,1630,1630,61,0,0,0
64256,application_1508364558011_3968,1,39299,39299,64256,24957,24957,675,0,0,0
64276,application_1508364558011_9023,1,41851,41851,64276,22425,22425,558,0,0,0
64276,application_1508364558011_26242,1,58636,58636,64276,5640,5640,98,0,0,0
64368,application_1508364558011_11573,1,43299,43299,64368,21069,21069,619,0,0,0
64406,application_1506638472019_11486,1,18728,18728,64406,45678,45678,1465,0,0,0
64406,application_1508364558011_3853,1,39291,39291,64406,25115,25115,713,0,0,0
64406,application_1508364558011_15752,1,46015,46015,64406,18391,18391,432,0,0,0
64445,application_1508364558011_18582,1,47997,47997,64445,16448,16448,453,0,0,0
64486,application_1508364558011_0290,1,37433,37433,64486,27053,27053,753,0,0,0
64506,application_1506638472019_4550,1,15631,15631,64506,48875,48875,2265,0,0,0
64536,application_1508364558011_4281,1,39363,39363,64536,25173,25173,577,0,0,0
64536,application_1508364558011_26554,1,59003,59003,64536,5533,5533,121,0,0,0
64556,application_1506638472019_21372,1,26283,26283,64556,38273,38273,1489,0,0,0
64631,application_1508364558011_27688,1,61406,61406,64631,3225,3225,57,0,0,0
64666,application_1508364558011_12092,1,43472,43472,64666,21194,21194,617,0,0,0
64686,application_1508364558011_22417,1,53787,53787,64686,10899,10899,249,0,0,0
64738,application_1508364558011_2225,1,39001,39001,64738,25737,25737,728,0,0,0
64756,application_1508364558011_27612,1,61106,61106,64756,3650,3650,74,0,0,0
64797,application_1508364558011_3926,1,39298,39298,64797,25499,25499,660,0,0,0
64882,application_1506638472019_38027,1,36090,36090,64882,28792,28792,798,0,0,0
64902,application_1508364558011_28346,1,63828,63828,64902,1074,1074,26,0,0,0
64912,application_1508364558011_22886,1,54791,54791,64912,10121,10121,238,0,0,0
64912,application_1508364558011_26141,1,58536,58536,64912,6376,6376,105,0,0,0
64926,application_1508364558011_28472,1,64146,64146,64926,780,780,66,0,0,0
64926,application_1508364558011_1967,1,38855,38855,64926,26071,26071,629,0,0,0
64948,application_1508364558011_27385,1,60346,60346,64948,4602,4602,138,0,0,0
64958,application_1508364558011_26911,1,59584,59584,64958,5374,5374,107,0,0,0
64988,application_1508364558011_27586,1,60986,60986,64988,4002,4002,75,0,0,0
65006,application_1508364558011_27893,1,62036,62036,65006,2970,2970,63,0,0,0
65016,application_1508364558011_28378,1,63876,63876,65016,1140,1140,63,0,0,0
65026,application_1508364558011_25985,1,58146,58146,65026,6880,6880,143,0,0,0
65046,application_1506638472019_12005,1,18805,18805,65046,46241,46241,1551,0,0,0
65066,application_1508364558011_2337,1,39005,39005,65066,26061,26061,683,0,0,0
65066,application_1508364558011_9114,1,41853,41853,65066,23213,23213,649,0,0,0
65136,application_1506638472019_20049,1,25136,25136,65136,40000,40000,1299,0,0,0
65146,application_1508364558011_25875,1,57946,57946,65146,7200,7200,143,0,0,0
65178,application_1508364558011_28198,1,63446,63446,65178,1732,1732,54,0,0,0
65188,application_1508364558011_28384,1,63886,63886,65188,1302,1302,66,0,0,0
65246,application_1508364558011_28203,1,63476,63476,65246,1770,1770,51,0,0,0
65256,application_1508364558011_21545,1,50781,50781,65256,14475,14475,327,0,0,0
65266,application_1508364558011_1958,1,38855,38855,65266,26411,26411,678,0,0,0
65366,application_1508364558011_26156,1,58554,58554,65366,6812,6812,89,0,0,0
65366,application_1508364558011_28142,1,63236,63236,65366,2130,2130,65,0,0,0
65366,application_1508364558011_8962,1,41850,41850,65366,23516,23516,486,0,0,0
65396,application_1508364558011_28127,1,63126,63126,65396,2270,2270,52,0,0,0
65416,application_1508364558011_5731,1,40039,40039,65416,25377,25377,688,0,0,0
65479,application_1508364558011_9190,1,41854,41854,65479,23625,23625,631,0,0,0
65499,application_1508364558011_1799,1,38838,38838,65499,26661,26661,779,0,0,0
65529,application_1508364558011_6677,1,40813,40813,65529,24716,24716,483,0,0,0
65549,application_1508364558011_28393,1,63895,63895,65549,1654,1654,50,0,0,0
65549,application_1508364558011_19271,1,48767,48767,65549,16782,16782,547,0,0,0
65576,application_1506638472019_38745,1,36727,36727,65576,28849,28849,612,0,0,0
65586,application_1506638472019_20063,1,25140,25140,65586,40446,40446,1233,0,0,0
65659,application_1508364558011_2232,1,39002,39002,65659,26657,26657,817,0,0,0
65669,application_1508364558011_13728,1,44692,44692,65669,20977,20977,625,0,0,0
65699,application_1506638472019_12089,1,18814,18814,65699,46885,46885,1528,0,0,0
65699,application_1508364558011_27563,1,60907,60907,65699,4792,4792,112,0,0,0
65709,application_1508364558011_3256,1,39217,39217,65709,26492,26492,873,0,0,0
65719,application_1508364558011_9881,1,42139,42139,65719,23580,23580,546,0,0,0
65758,application_1508364558011_28115,1,63056,63056,65758,2702,2702,58,0,0,0
65768,application_1506638472019_38122,1,36237,36237,65768,29531,29531,977,0,0,0
65778,application_1506638472019_20024,1,25130,25130,65778,40648,40648,1297,0,0,0
65816,application_1508364558011_25218,1,57432,57432,65816,8384,8384,158,0,0,0
65816,application_1508364558011_19288,1,48768,48768,65816,17048,17048,514,0,0,0
65836,application_1508364558011_19918,1,49212,49212,65836,16624,16624,503,0,0,0
65846,application_1508364558011_9815,1,42138,42138,65846,23708,23708,565,0,0,0
65846,application_1508364558011_17289,1,47388,47388,65846,18458,18458,460,0,0,0
65886,application_1508364558011_7637,1,41481,41481,65886,24405,24405,670,0,0,0
65920,application_1508364558011_8976,1,41850,41850,65920,24070,24070,701,0,0,0
65961,application_1508364558011_27889,1,62026,62026,65961,3935,3935,70,0,0,0
65971,application_1508364558011_17091,1,47279,47279,65971,18692,18692,495,0,0,0
65986,application_1508364558011_28206,1,63486,63486,65986,2500,2500,54,0,0,0
65991,application_1508364558011_12715,1,43627,43627,65991,22364,22364,630,0,0,0
66012,application_1508364558011_27825,1,61876,61876,66012,4136,4136,67,0,0,0
66012,application_1508364558011_27972,1,62356,62356,66012,3656,3656,57,0,0,0
66032,application_1508364558011_27488,1,60646,60646,66032,5386,5386,98,0,0,0
66076,application_1508364558011_28674,1,64692,64692,66076,1384,1384,38,0,0,0
66076,application_1508364558011_21753,2,51335,51335,66076,14741,14741,12,0,0,0
66076,application_1508364558011_22015,2,52077,52077,66076,13999,13999,16,0,0,0
66090,application_1508364558011_28185,1,63396,63396,66090,2694,2694,73,0,0,0
66090,application_1508364558011_22099,2,52521,52521,66090,13569,13569,10,0,0,0
66090,application_1508364558011_22241,2,53264,53264,66090,12826,12826,14,0,0,0
66099,application_1506638472019_2741,1,13305,13305,66099,52794,52794,2858,0,0,0
66099,application_1508364558011_3489,1,39237,39237,66099,26862,26862,699,0,0,0
66116,application_1508364558011_2282,1,39004,39004,66116,27112,27112,769,0,0,0
66116,application_1508364558011_22662,2,54443,54443,66116,11673,11673,25,0,0,0
66120,application_1506638472019_3265,1,13380,13380,66120,52740,52740,2750,0,0,0
66220,application_1508364558011_28082,1,62926,62926,66220,3294,3294,55,0,0,0
66225,application_1508364558011_26163,1,58563,58563,66225,7662,7662,198,0,0,0
66229,application_1508364558011_25925,1,58026,58026,66229,8203,8203,165,0,0,0
66246,application_1508364558011_28053,1,62766,62766,66246,3480,3480,71,0,0,0
66258,application_1508364558011_4727,1,39804,39804,66258,26454,26454,603,0,0,0
66296,application_1508364558011_20184,1,49330,49330,66296,16966,16966,509,0,0,0
66316,application_1508364558011_28431,1,63966,63966,66316,2350,2350,59,0,0,0
66316,application_1508364558011_28153,1,63286,63286,66316,3030,3030,57,0,0,0
66316,application_1508364558011_9186,1,41854,41854,66316,24462,24462,518,0,0,0
66380,application_1508364558011_27343,1,60247,60247,66380,6133,6133,102,0,0,0
66390,application_1508364558011_13737,1,44693,44693,66390,21697,21697,574,0,0,0
66448,application_1508364558011_10693,1,42172,42172,66448,24276,24276,609,0,0,0
66456,application_1506638472019_2840,1,13313,13313,66456,53143,53143,2824,0,0,0
66501,application_1508364558011_28026,1,62626,62626,66501,3875,3875,71,0,0,0
66521,application_1508364558011_5347,1,39872,39872,66521,26649,26649,632,0,0,0
66526,application_1508364558011_28760,1,64775,64775,66526,1751,1751,28,0,0,0
66566,application_1508364558011_14807,1,45363,45363,66566,21203,21203,583,0,0,0
66614,application_1508364558011_6841,1,40816,40816,66614,25798,25798,584,0,0,0
66618,application_1508364558011_28621,1,64546,64546,66618,2072,2072,66,0,0,0
66648,application_1508364558011_2274,1,39004,39004,66648,27644,27644,752,0,0,0
66648,application_1508364558011_10306,1,42148,42148,66648,24500,24500,695,0,0,0
66648,application_1508364558011_27839,1,61936,61936,66648,4712,4712,94,0,0,0
66699,application_1508364558011_10666,1,42171,42171,66699,24528,24528,685,0,0,0
66734,application_1508364558011_10266,1,42147,42147,66734,24587,24587,727,0,0,0
66763,application_1508364558011_7660,1,41482,41482,66763,25281,25281,656,0,0,0
66763,application_1508364558011_22595,1,54315,54315,66763,12448,12448,328,0,0,0
66806,application_1508364558011_5198,1,39864,39864,66806,26942,26942,769,0,0,0
66806,application_1508364558011_4848,1,39809,39809,66806,26997,26997,842,0,0,0
66836,application_1508364558011_28395,1,63896,63896,66836,2940,2940,67,0,0,0
66846,application_1508364558011_26349,1,58709,58709,66846,8137,8137,98,0,0,0
66866,application_1508364558011_10251,1,42147,42147,66866,24719,24719,531,0,0,0
66876,application_1508364558011_11516,1,43296,43296,66876,23580,23580,566,0,0,0
66901,application_1508364558011_28568,1,64396,64396,66901,2505,2505,73,0,0,0
66976,application_1508364558011_14259,1,44954,44954,66976,22022,22022,644,0,0,0
66986,application_1508364558011_2544,1,39022,39022,66986,27964,27964,717,0,0,0
67031,application_1508364558011_11546,1,43298,43298,67031,23733,23733,597,0,0,0
67041,application_1508364558011_23303,1,55936,55936,67041,11105,11105,293,0,0,0
67051,application_1508364558011_28464,1,64116,64116,67051,2935,2935,68,0,0,0
67081,application_1508364558011_28609,1,64476,64476,67081,2605,2605,56,0,0,0
67081,application_1508364558011_9870,1,42139,42139,67081,24942,24942,780,0,0,0
67101,application_1508364558011_12079,1,43471,43471,67101,23630,23630,555,0,0,0
67141,application_1508364558011_19815,1,49203,49203,67141,17938,17938,477,0,0,0
67186,application_1508364558011_1956,1,38855,38855,67186,28331,28331,838,0,0,0
67216,application_1506638472019_20039,1,25134,25134,67216,42082,42082,1296,0,0,0
67276,application_1508364558011_4195,1,39362,39362,67276,27914,27914,698,0,0,0
67287,application_1506638472019_2802,1,13310,13310,67287,53977,53977,3267,0,0,0
67287,application_1508364558011_3495,1,39238,39238,67287,28049,28049,635,0,0,0
67297,application_1506638472019_3483,1,13434,13434,67297,53863,53863,2684,0,0,0
67304,application_1506638472019_38121,1,36237,36237,67304,31067,31067,878,0,0,0
67319,application_1508364558011_28726,1,64736,64736,67319,2583,2583,59,0,0,0
67327,application_1508364558011_28996,1,65236,65236,67327,2091,2091,71,0,0,0
67342,application_1508364558011_29181,1,65356,65356,67342,1986,1986,62,0,0,0
67352,application_1508364558011_23301,2,55929,55929,67352,11423,11423,28,0,0,0
67366,application_1508364558011_16362,1,46505,46505,67366,20861,20861,574,0,0,0
67371,application_1508364558011_23537,2,56069,56069,67371,11302,11302,18,0,0,0
67386,application_1508364558011_24249,2,56496,56496,67386,10890,10890,10,0,0,0
67396,application_1508364558011_24455,2,56937,56937,67396,10459,10459,10,0,0,0
67426,application_1508364558011_17069,1,47278,47278,67426,20148,20148,534,0,0,0
67445,application_1508364558011_29476,1,66050,66050,67445,1395,1395,49,0,0,0
67500,application_1508364558011_0426,1,37558,37558,67500,29942,29942,940,0,0,0
67500,application_1508364558011_22051,1,52227,52227,67500,15273,15273,390,0,0,0
67526,application_1508364558011_15236,1,45567,45567,67526,21959,21959,696,0,0,0
67527,application_1508364558011_13739,1,44693,44693,67527,22834,22834,610,0,0,0
67598,application_1506638472019_3139,1,13371,13371,67598,54227,54227,2694,0,0,0
67598,application_1506638472019_3338,1,13386,13386,67598,54212,54212,2947,0,0,0
67618,application_1508364558011_29775,1,66199,66199,67618,1419,1419,76,0,0,0
67656,application_1508364558011_29613,1,66106,66106,67656,1550,1550,64,0,0,0
67669,application_1508364558011_28902,1,64996,64996,67669,2673,2673,66,0,0,0
67679,application_1506638472019_38045,1,36092,36092,67679,31587,31587,961,0,0,0
67689,application_1508364558011_28470,1,64136,64136,67689,3553,3553,66,0,0,0
67689,application_1508364558011_2654,1,39056,39056,67689,28633,28633,821,0,0,0
67699,application_1506638472019_20084,1,25143,25143,67699,42556,42556,1292,0,0,0
67770,application_1508364558011_14781,1,45346,45346,67770,22424,22424,594,0,0,0
67790,application_1508364558011_4318,1,39364,39364,67790,28426,28426,816,0,0,0
67807,application_1508364558011_5263,1,39867,39867,67807,27940,27940,666,0,0,0
67836,application_1508364558011_11554,1,43298,43298,67836,24538,24538,633,0,0,0
67846,application_1508364558011_2297,1,39004,39004,67846,28842,28842,655,0,0,0
67846,application_1508364558011_8238,1,41626,41626,67846,26220,26220,711,0,0,0
67896,application_1508364558011_29191,1,65376,65376,67896,2520,2520,72,0,0,0
67926,application_1508364558011_9519,1,42066,42066,67926,25860,25860,744,0,0,0
67946,application_1508364558011_5695,1,40039,40039,67946,27907,27907,746,0,0,0
67956,application_1508364558011_28647,1,64636,64636,67956,3320,3320,57,0,0,0
67956,application_1508364558011_28792,1,64816,64816,67956,3140,3140,61,0,0,0
67975,application_1508364558011_29393,1,65936,65936,67975,2039,2039,69,0,0,0
68005,application_1508364558011_1690,1,38783,38783,68005,29222,29222,743,0,0,0
68005,application_1508364558011_29562,1,66090,66090,68005,1915,1915,47,0,0,0
68025,application_1508364558011_29337,1,65846,65846,68025,2179,2179,65,0,0,0
68028,application_1508364558011_29430,1,65976,65976,68028,2052,2052,63,0,0,0
68038,application_1508364558011_29421,1,65956,65956,68038,2082,2082,59,0,0,0
68048,application_1508364558011_30167,1,66406,66406,68048,1642,1642,74,0,0,0
68048,application_1508364558011_5267,1,39867,39867,68048,28181,28181,563,0,0,0
68058,application_1506638472019_17673,1,24403,24403,68058,43655,43655,1676,0,0,0
68106,application_1508364558011_28542,1,64336,64336,68106,3770,3770,66,0,0,0
68126,application_1508364558011_29377,1,65910,65910,68126,2216,2216,39,0,0,0
68192,application_1508364558011_26478,1,58890,58890,68192,9302,9302,192,0,0,0
68192,application_1508364558011_7718,1,41512,41512,68192,26680,26680,691,0,0,0
68202,application_1508364558011_30348,1,66736,66736,68202,1466,1466,58,0,0,0
68232,application_1508364558011_26502,1,58920,58920,68232,9312,9312,198,0,0,0
68242,application_1506638472019_11121,1,18676,18676,68242,49566,49566,1782,0,0,0
68259,application_1508364558011_30067,1,66276,66276,68259,1983,1983,67,0,0,0
68311,application_1508364558011_28681,1,64696,64696,68311,3615,3615,63,0,0,0
68322,application_1508364558011_11574,1,43299,43299,68322,25023,25023,675,0,0,0
68332,application_1508364558011_2488,1,39016,39016,68332,29316,29316,828,0,0,0
68332,application_1506638472019_36999,1,35533,35533,68332,32799,32799,1016,0,0,0
68381,application_1506638472019_21672,1,26314,26314,68381,42067,42067,1459,0,0,0
68383,application_1508364558011_5109,1,39862,39862,68383,28521,28521,700,0,0,0
68404,application_1506638472019_8115,1,17290,17290,68404,51114,51114,1894,0,0,0
68420,application_1508364558011_9652,1,42068,42068,68420,26352,26352,703,0,0,0
68476,application_1508364558011_9800,1,42138,42138,68476,26338,26338,681,0,0,0
68496,application_1508364558011_9529,1,42066,42066,68496,26430,26430,715,0,0,0
68506,application_1506638472019_38961,1,37037,37037,68506,31469,31469,920,0,0,0
68506,application_1508364558011_29683,1,66165,66165,68506,2341,2341,26,0,0,0
68516,application_1508364558011_9644,1,42068,42068,68516,26448,26448,765,0,0,0
68587,application_1508364558011_3899,1,39296,39296,68587,29291,29291,655,0,0,0
68587,application_1508364558011_29354,1,65886,65886,68587,2701,2701,60,0,0,0
68597,application_1508364558011_30377,1,66796,66796,68597,1801,1801,60,0,0,0
68612,application_1508364558011_18690,1,48011,48011,68612,20601,20601,612,0,0,0
68640,application_1508364558011_1822,1,38840,38840,68640,29800,29800,773,0,0,0
68659,application_1508364558011_25618,2,57547,57547,68659,11112,11112,19,0,0,0
68679,application_1508364558011_25903,2,57983,57983,68679,10696,10696,13,0,0,0
68703,application_1508364558011_30289,1,66618,66618,68703,2085,2085,64,0,0,0
68718,application_1508364558011_2325,1,39005,39005,68718,29713,29713,691,0,0,0
68728,application_1506638472019_4036,1,14318,14318,68728,54410,54410,2532,0,0,0
68748,application_1508364558011_6738,1,40814,40814,68748,27934,27934,654,0,0,0
68771,application_1508364558011_25071,1,57414,57414,68771,11357,11357,260,0,0,0
68781,application_1508364558011_31573,1,67807,67807,68781,974,974,43,0,0,0
68781,application_1508364558011_25911,2,57996,57996,68781,10785,10785,102,0,0,0
68800,application_1506638472019_38139,1,36237,36237,68800,32563,32563,928,0,0,0
68807,application_1506638472019_4448,1,15396,15396,68807,53411,53411,2432,0,0,0
68831,application_1508364558011_17100,1,47280,47280,68831,21551,21551,543,0,0,0
68870,application_1508364558011_29375,1,65906,65906,68870,2964,2964,61,0,0,0
68983,application_1508364558011_29767,1,66197,66197,68983,2786,2786,55,0,0,0
69003,application_1506638472019_21898,1,26340,26340,69003,42663,42663,1457,0,0,0
69003,application_1508364558011_30296,1,66628,66628,69003,2375,2375,60,0,0,0
69003,application_1508364558011_19871,1,49208,49208,69003,19795,19795,487,0,0,0
69005,application_1508364558011_28619,1,64536,64536,69005,4469,4469,59,0,0,0
69006,application_1508364558011_11566,1,43299,43299,69006,25707,25707,567,0,0,0
69083,application_1508364558011_12112,1,43472,43472,69083,25611,25611,688,0,0,0
69093,application_1508364558011_31261,1,67366,67366,69093,1727,1727,65,0,0,0
69105,application_1506638472019_22687,1,26948,26948,69105,42157,42157,1456,0,0,0
69131,application_1508364558011_20171,1,49329,49329,69131,19802,19802,587,0,0,0
69156,application_1508364558011_31333,1,67476,67476,69156,1680,1680,65,0,0,0
69176,application_1508364558011_30371,1,66786,66786,69176,2390,2390,69,0,0,0
69208,application_1508364558011_29256,1,65566,65566,69208,3642,3642,63,0,0,0
69249,application_1508364558011_4705,1,39804,39804,69249,29445,29445,648,0,0,0
69346,application_1508364558011_29363,1,65896,65896,69346,3450,3450,58,0,0,0
69356,application_1508364558011_29653,1,66126,66126,69356,3230,3230,89,0,0,0
69384,application_1508364558011_8374,1,41628,41628,69384,27756,27756,667,0,0,0
69421,application_1508364558011_30294,1,66626,66626,69421,2795,2795,72,0,0,0
69425,application_1508364558011_10063,1,42141,42141,69425,27284,27284,668,0,0,0
69436,application_1508364558011_31629,1,67906,67906,69436,1530,1530,62,0,0,0
69436,application_1508364558011_31585,1,67826,67826,69436,1610,1610,74,0,0,0
69436,application_1508364558011_7255,1,41279,41279,69436,28157,28157,559,0,0,0
69462,application_1506638472019_37968,1,36087,36087,69462,33375,33375,928,0,0,0
69482,application_1508364558011_28807,1,64851,64851,69482,4631,4631,161,0,0,0
69516,application_1508364558011_8310,1,41627,41627,69516,27889,27889,717,0,0,0
69530,application_1508364558011_2285,1,39004,39004,69530,30526,30526,747,0,0,0
69538,application_1508364558011_4238,1,39363,39363,69538,30175,30175,659,0,0,0
69538,application_1508364558011_19326,1,48770,48770,69538,20768,20768,513,0,0,0
69556,application_1508364558011_0858,4,37970,37970,69556,31586,31586,909,0,0,0
69576,application_1508364558011_14466,1,45028,45028,69576,24548,24548,681,0,0,0
69576,application_1508364558011_31716,1,68106,68106,69576,1470,1470,67,0,0,0
69586,application_1506638472019_22238,1,26531,26531,69586,43055,43055,1470,0,0,0
69605,application_1506638472019_21418,1,26289,26289,69605,43316,43316,1507,0,0,0
69621,application_1508364558011_32620,1,68790,68790,69621,831,831,23,0,0,0
69621,application_1506638472019_39116,1,37059,37059,69621,32562,32562,970,0,0,0
69656,application_1508364558011_10270,1,42148,42148,69656,27508,27508,822,0,0,0
69656,application_1508364558011_18387,1,47947,47947,69656,21709,21709,481,0,0,0
69666,application_1506638472019_37712,1,35976,35976,69666,33690,33690,842,0,0,0
69676,application_1508364558011_8216,1,41625,41625,69676,28051,28051,867,0,0,0
69676,application_1508364558011_3883,1,39295,39295,69676,30381,30381,869,0,0,0
69733,application_1508364558011_29320,1,65816,65816,69733,3917,3917,59,0,0,0
69733,application_1508364558011_26037,2,58285,58285,69733,11448,11448,7,0,0,0
69751,application_1508364558011_26166,2,58569,58569,69751,11182,11182,18,0,0,0
69768,application_1508364558011_26238,2,58629,58629,69768,11139,11139,17,0,0,0
69830,application_1508364558011_7292,1,41280,41280,69830,28550,28550,683,0,0,0
69830,application_1508364558011_22888,1,54792,54792,69830,15038,15038,345,0,0,0
69830,application_1508364558011_3723,1,39259,39259,69830,30571,30571,818,0,0,0
69855,application_1508364558011_27027,2,59812,59812,69855,10043,10043,7,0,0,0
69894,application_1508364558011_27080,2,59960,59960,69894,9934,9934,38,0,0,0
69914,application_1508364558011_27464,2,60552,60552,69914,9362,9362,11,0,0,0
69934,application_1508364558011_31569,1,67801,67801,69934,2133,2133,56,0,0,0
69934,application_1508364558011_27486,2,60640,60640,69934,9294,9294,19,0,0,0
69986,application_1508364558011_30846,1,67216,67216,69986,2770,2770,67,0,0,0
69986,application_1508364558011_30428,1,66916,66916,69986,3070,3070,71,0,0,0
69996,application_1508364558011_21396,1,50725,50725,69996,19271,19271,514,0,0,0
70006,application_1508364558011_15511,1,45843,45843,70006,24163,24163,519,0,0,0
70006,application_1508364558011_22689,1,54459,54459,70006,15547,15547,381,0,0,0
70035,application_1508364558011_27534,2,60852,60852,70035,9183,9183,93,0,0,0
70045,application_1508364558011_31504,1,67669,67669,70045,2376,2376,47,0,0,0
70061,application_1508364558011_27827,2,61883,61883,70061,8178,8178,21,0,0,0
70067,application_1508364558011_5817,1,40041,40041,70067,30026,30026,867,0,0,0
70077,application_1508364558011_27909,2,62118,62118,70077,7959,7959,8,0,0,0
70086,application_1506638472019_22032,1,26366,26366,70086,43720,43720,1538,0,0,0
70096,application_1508364558011_6724,1,40814,40814,70096,29282,29282,577,0,0,0
70096,application_1508364558011_8977,1,41850,41850,70096,28246,28246,697,0,0,0
70096,application_1506638472019_22239,1,26531,26531,70096,43565,43565,1506,0,0,0
70096,application_1508364558011_28137,2,63203,63203,70096,6893,6893,16,0,0,0
70106,application_1508364558011_28270,2,63611,63611,70106,6495,6495,10,0,0,0
70116,application_1508364558011_28565,2,64392,64392,70116,5724,5724,9,0,0,0
70138,application_1508364558011_31472,1,67636,67636,70138,2502,2502,71,0,0,0
70138,application_1508364558011_28632,2,64590,64590,70138,5548,5548,21,0,0,0
70158,application_1508364558011_28734,2,64746,64746,70158,5412,5412,17,0,0,0
70161,application_1508364558011_18407,1,47948,47948,70161,22213,22213,565,0,0,0
70190,application_1508364558011_22693,1,54459,54459,70190,15731,15731,439,0,0,0
70244,application_1508364558011_30813,1,67146,67146,70244,3098,3098,71,0,0,0
70275,application_1508364558011_31387,1,67588,67588,70275,2687,2687,48,0,0,0
70286,application_1508364558011_20454,1,49643,49643,70286,20643,20643,493,0,0,0
70286,application_1508364558011_30898,1,67276,67276,70286,3010,3010,78,0,0,0
70333,application_1508364558011_5259,1,39867,39867,70333,30466,30466,770,0,0,0
70333,application_1508364558011_3461,1,39234,39234,70333,31099,31099,732,0,0,0
70339,application_1508364558011_19829,1,49205,49205,70339,21134,21134,517,0,0,0
70423,application_1508364558011_29407,1,65943,65943,70423,4480,4480,101,0,0,0
70423,application_1508364558011_20192,1,49331,49331,70423,21092,21092,528,0,0,0
70436,application_1508364558011_34832,1,69814,69814,70436,622,622,20,0,0,0
70456,application_1508364558011_6759,1,40814,40814,70456,29642,29642,732,0,0,0
70456,application_1508364558011_32693,1,68926,68926,70456,1530,1530,68,0,0,0
70466,application_1508364558011_31566,1,67793,67793,70466,2673,2673,88,0,0,0
70517,application_1508364558011_19860,1,49207,49207,70517,21310,21310,602,0,0,0
70517,application_1508364558011_10663,1,42171,42171,70517,28346,28346,689,0,0,0
70517,application_1508364558011_18331,1,47943,47943,70517,22574,22574,608,0,0,0
70536,application_1508364558011_21680,1,50964,50964,70536,19572,19572,534,0,0,0
70556,application_1508364558011_5113,1,39862,39862,70556,30694,30694,910,0,0,0
70586,application_1506638472019_2912,1,13319,13319,70586,57267,57267,3315,0,0,0
70731,application_1508364558011_30311,1,66666,66666,70731,4065,4065,56,0,0,0
70731,application_1508364558011_11602,1,43300,43300,70731,27431,27431,656,0,0,0
70751,application_1508364558011_31267,1,67376,67376,70751,3375,3375,72,0,0,0
70765,application_1508364558011_2648,1,39056,39056,70765,31709,31709,897,0,0,0
70800,application_1508364558011_6806,1,40815,40815,70800,29985,29985,846,0,0,0
70810,application_1508364558011_1960,1,38855,38855,70810,31955,31955,773,0,0,0
70848,application_1508364558011_32915,16,69229,69229,70848,1619,1619,47,0,0,0
70866,application_1506638472019_21494,1,26298,26298,70866,44568,44568,1456,0,0,0
70876,application_1508364558011_30884,1,67261,67261,70876,3615,3615,63,0,0,0
70876,application_1508364558011_4262,1,39363,39363,70876,31513,31513,818,0,0,0
70911,application_1508364558011_32846,1,69118,69118,70911,1793,1793,37,0,0,0
70911,application_1508364558011_29671,2,66152,66152,70911,4759,4759,102,0,0,0
70953,application_1508364558011_31756,1,68156,68156,70953,2797,2797,63,0,0,0
70988,application_1508364558011_10300,1,42148,42148,70988,28840,28840,844,0,0,0
71007,application_1508364558011_10671,1,42171,42171,71007,28836,28836,663,0,0,0
71017,application_1508364558011_31588,1,67836,67836,71017,3181,3181,68,0,0,0
71031,application_1508364558011_31285,1,67396,67396,71031,3635,3635,70,0,0,0
71056,application_1508364558011_31354,1,67506,67506,71056,3550,3550,74,0,0,0
71086,application_1508364558011_6669,1,40813,40813,71086,30273,30273,795,0,0,0
71161,application_1508364558011_32814,1,69083,69083,71161,2078,2078,39,0,0,0
71171,application_1508364558011_15235,1,45567,45567,71171,25604,25604,759,0,0,0
71171,application_1508364558011_16480,1,46567,46567,71171,24604,24604,637,0,0,0
71181,application_1508364558011_8764,1,41647,41647,71181,29534,29534,670,0,0,0
71206,application_1508364558011_30221,2,66490,66490,71206,4716,4716,106,0,0,0
71216,application_1508364558011_1821,1,38840,38840,71216,32376,32376,845,0,0,0
71226,application_1508364558011_5277,1,39868,39868,71226,31358,31358,867,0,0,0
71226,application_1508364558011_19821,1,49204,49204,71226,22022,22022,506,0,0,0
71226,application_1508364558011_30413,2,66891,66891,71226,4335,4335,20,0,0,0
71282,application_1508364558011_5656,1,40038,40038,71282,31244,31244,892,0,0,0
71315,application_1508364558011_3306,1,39219,39219,71315,32096,32096,898,0,0,0
71325,application_1508364558011_4821,1,39808,39808,71325,31517,31517,801,0,0,0
71325,application_1508364558011_13910,1,44820,44820,71325,26505,26505,720,0,0,0
71325,application_1508364558011_9854,1,42138,42138,71325,29187,29187,704,0,0,0
71335,application_1508364558011_5307,1,39869,39869,71335,31466,31466,833,0,0,0
71345,application_1508364558011_30868,1,67246,67246,71345,4099,4099,71,0,0,0
71365,application_1508364558011_31254,1,67356,67356,71365,4009,4009,78,0,0,0
71372,application_1508364558011_5732,1,40039,40039,71372,31333,31333,820,0,0,0
71392,application_1508364558011_13736,1,44693,44693,71392,26699,26699,650,0,0,0
71438,application_1506638472019_38155,1,36238,36238,71438,35200,35200,839,0,0,0
71438,application_1508364558011_18413,1,47948,47948,71438,23490,23490,647,0,0,0
71438,application_1508364558011_28882,1,64938,64938,71438,6500,6500,188,0,0,0
71448,application_1508364558011_32089,1,68446,68446,71448,3002,3002,74,0,0,0
71458,application_1508364558011_22691,1,54459,54459,71458,16999,16999,415,0,0,0
71488,application_1508364558011_4837,1,39808,39808,71488,31680,31680,833,0,0,0
71498,application_1508364558011_35224,1,70006,70006,71498,1492,1492,70,0,0,0
71508,application_1508364558011_36120,1,70366,70366,71508,1142,1142,67,0,0,0
71508,application_1508364558011_32657,1,68846,68846,71508,2662,2662,75,0,0,0
71518,application_1508364558011_30864,1,67245,67245,71518,4273,4273,152,0,0,0
71518,application_1508364558011_31896,1,68389,68389,71518,3129,3129,146,0,0,0
71558,application_1508364558011_9095,1,41852,41852,71558,29706,29706,890,0,0,0
71568,application_1508364558011_29188,1,65372,65372,71568,6196,6196,265,0,0,0
71568,application_1508364558011_9918,1,42139,42139,71568,29429,29429,817,0,0,0
71588,application_1508364558011_18386,1,47947,47947,71588,23641,23641,730,0,0,0
71641,application_1506638472019_21731,1,26321,26321,71641,45320,45320,1494,0,0,0
71650,application_1508364558011_29883,1,66216,66216,71650,5434,5434,343,0,0,0
71660,application_1508364558011_34140,1,69753,69753,71660,1907,1907,216,0,0,0
71696,application_1508364558011_11683,1,43304,43304,71696,28392,28392,985,0,0,0
71716,application_1508364558011_1969,1,38856,38856,71716,32860,32860,1096,0,0,0
71716,application_1508364558011_9817,1,42138,42138,71716,29578,29578,1004,0,0,0
71736,application_1506638472019_11124,1,18677,18677,71736,53059,53059,2532,0,0,0
71736,application_1508364558011_27253,1,60191,60191,71736,11545,11545,641,0,0,0
71746,application_1506638472019_2994,1,13359,13359,71746,58387,58387,3605,0,0,0
71766,application_1508364558011_9060,1,41852,41852,71766,29914,29914,983,0,0,0
71793,application_1508364558011_29999,1,66233,66233,71793,5560,5560,484,0,0,0
71817,application_1508364558011_2527,1,39020,39020,71817,32797,32797,1096,0,0,0
71847,application_1506638472019_3496,1,13435,13435,71847,58412,58412,3527,0,0,0
71877,application_1508364558011_27299,1,60198,60198,71877,11679,11679,683,0,0,0
71877,application_1508364558011_11039,1,42908,42908,71877,28969,28969,1069,0,0,0
71887,application_1506638472019_7186,1,17163,17163,71887,54724,54724,2596,0,0,0
71897,application_1508364558011_15160,1,45566,45566,71897,26331,26331,1102,0,0,0
71897,application_1506638472019_18883,1,24785,24785,71897,47112,47112,1863,0,0,0
71916,application_1508364558011_2608,1,39029,39029,71916,32887,32887,971,0,0,0
71926,application_1506638472019_19152,1,24838,24838,71926,47088,47088,1845,0,0,0
71926,application_1508364558011_4252,1,39363,39363,71926,32563,32563,1387,0,0,0
71926,application_1506638472019_7509,1,17225,17225,71926,54701,54701,2617,0,0,0
71933,application_1508364558011_11454,1,43294,43294,71933,28639,28639,1156,0,0,0
71943,application_1508364558011_21434,1,50726,50726,71943,21217,21217,988,0,0,0
71973,application_1508364558011_27758,1,61579,61579,71973,10394,10394,617,0,0,0
71973,application_1508364558011_17409,1,47463,47463,71973,24510,24510,1060,0,0,0
71973,application_1508364558011_7277,1,41280,41280,71973,30693,30693,1396,0,0,0
71983,application_1506638472019_8845,1,17545,17545,71983,54438,54438,2672,0,0,0
71996,application_1506638472019_6967,1,17151,17151,71996,54845,54845,2512,0,0,0
71996,application_1508364558011_12256,1,43515,43515,71996,28481,28481,907,0,0,0
72026,application_1506638472019_18097,1,24533,24533,72026,47493,47493,2080,0,0,0
72046,application_1508364558011_3509,1,39239,39239,72046,32807,32807,1388,0,0,0
72046,application_1508364558011_9398,1,42064,42064,72046,29982,29982,1340,0,0,0
72046,application_1506638472019_9029,1,17572,17572,72046,54474,54474,2739,0,0,0
72056,application_1506638472019_19520,1,24914,24914,72056,47142,47142,1849,0,0,0
72056,application_1506638472019_21890,1,26339,26339,72056,45717,45717,1506,0,0,0
72074,application_1508364558011_3220,1,39215,39215,72074,32859,32859,1460,0,0,0
72086,application_1506638472019_18743,1,24628,24628,72086,47458,47458,2199,0,0,0
72101,application_1506638472019_7451,1,17219,17219,72101,54882,54882,2545,0,0,0
72127,application_1508364558011_24966,1,57398,57398,72127,14729,14729,776,0,0,0
72127,application_1506638472019_18538,1,24606,24606,72127,47521,47521,2207,0,0,0
72133,application_1508364558011_20154,1,49328,49328,72133,22805,22805,544,0,0,0
72150,application_1508364558011_15284,1,45568,45568,72150,26582,26582,1141,0,0,0
72170,application_1508364558011_2198,1,38999,38999,72170,33171,33171,1523,0,0,0
72196,application_1508364558011_19886,1,49209,49209,72196,22987,22987,487,0,0,0
72242,application_1508364558011_36544,1,70856,70856,72242,1386,1386,58,0,0,0
72277,application_1508364558011_19778,1,49200,49200,72277,23077,23077,637,0,0,0
72277,application_1508364558011_7250,1,41279,41279,72277,30998,30998,853,0,0,0
72306,application_1508364558011_31363,2,67527,67527,72306,4779,4779,6,0,0,0
72310,application_1508364558011_28271,1,63611,63611,72310,8699,8699,169,0,0,0
72323,application_1508364558011_31960,2,68414,68414,72323,3909,3909,17,0,0,0
72336,application_1508364558011_31143,1,67327,67327,72336,5009,5009,192,0,0,0
72346,application_1508364558011_20412,1,49639,49639,72346,22707,22707,593,0,0,0
72366,application_1508364558011_31765,1,68172,68172,72366,4194,4194,123,0,0,0
72366,application_1508364558011_7691,1,41484,41484,72366,30882,30882,826,0,0,0
72376,application_1506638472019_22192,1,26526,26526,72376,45850,45850,1475,0,0,0
72376,application_1506638472019_6411,1,17063,17063,72376,55313,55313,2454,0,0,0
72420,application_1508364558011_10607,1,42169,42169,72420,30251,30251,990,0,0,0
72420,application_1508364558011_8987,1,41850,41850,72420,30570,30570,814,0,0,0
72440,application_1508364558011_20167,1,49329,49329,72440,23111,23111,519,0,0,0
72440,application_1508364558011_33195,2,69249,69249,72440,3191,3191,11,0,0,0
72486,application_1508364558011_11341,1,43062,43062,72486,29424,29424,859,0,0,0
72516,application_1508364558011_31337,1,67480,67480,72516,5036,5036,176,0,0,0
72516,application_1508364558011_19892,1,49210,49210,72516,23306,23306,590,0,0,0
72536,application_1508364558011_31196,1,67330,67330,72536,5206,5206,211,0,0,0
72546,application_1508364558011_35993,1,70234,70234,72546,2312,2312,160,0,0,0
72556,application_1508364558011_8736,1,41647,41647,72556,30909,30909,842,0,0,0
72566,application_1508364558011_23047,1,55417,55417,72566,17149,17149,470,0,0,0
72566,application_1508364558011_18661,1,48010,48010,72566,24556,24556,637,0,0,0
72586,application_1508364558011_3434,1,39231,39231,72586,33355,33355,1075,0,0,0
72596,application_1508364558011_7298,1,41280,41280,72596,31316,31316,822,0,0,0
72606,application_1508364558011_10250,1,42147,42147,72606,30459,30459,753,0,0,0
72616,application_1508364558011_33889,1,69698,69698,72616,2918,2918,216,0,0,0
72668,application_1506638472019_37087,1,35537,35537,72668,37131,37131,1125,0,0,0
72680,application_1506638472019_7550,1,17229,17229,72680,55451,55451,2580,0,0,0
72740,application_1508364558011_34814,1,69786,69786,72740,2954,2954,66,0,0,0
72770,application_1506638472019_24875,1,27759,27759,72770,45011,45011,1374,0,0,0
72792,application_1508364558011_18684,1,48011,48011,72792,24781,24781,639,0,0,0
72813,application_1508364558011_19477,1,48902,48902,72813,23911,23911,527,0,0,0
72813,application_1508364558011_20161,1,49329,49329,72813,23484,23484,614,0,0,0
72843,application_1506638472019_22023,1,26365,26365,72843,46478,46478,1458,0,0,0
72863,application_1508364558011_12724,1,43627,43627,72863,29236,29236,696,0,0,0
72863,application_1506638472019_37047,1,35535,35535,72863,37328,37328,1045,0,0,0
72893,application_1508364558011_33224,1,69283,69283,72893,3610,3610,92,0,0,0
72903,application_1508364558011_30963,1,67313,67313,72903,5590,5590,174,0,0,0
72913,application_1508364558011_2501,1,39017,39017,72913,33896,33896,898,0,0,0
72913,application_1506638472019_5404,1,15893,15893,72913,57020,57020,2466,0,0,0
72923,application_1506638472019_19962,1,25055,25055,72923,47868,47868,1822,0,0,0
72923,application_1508364558011_24934,1,57395,57395,72923,15528,15528,420,0,0,0
72993,application_1508364558011_14206,1,44952,44952,72993,28041,28041,856,0,0,0
73023,application_1508364558011_9622,1,42067,42067,73023,30956,30956,932,0,0,0
73023,application_1508364558011_3903,1,39297,39297,73023,33726,33726,1127,0,0,0
73033,application_1506638472019_6573,1,17085,17085,73033,55948,55948,2473,0,0,0
73086,application_1506638472019_24148,1,27348,27348,73086,45738,45738,1327,0,0,0
73096,application_1506638472019_18243,1,24564,24564,73096,48532,48532,2043,0,0,0
73106,application_1508364558011_5225,1,39865,39865,73106,33241,33241,717,0,0,0
73106,application_1508364558011_32870,1,69156,69156,73106,3950,3950,55,0,0,0
73106,application_1508364558011_12116,1,43473,43473,73106,29633,29633,657,0,0,0
73106,application_1508364558011_34417,1,69776,69776,73106,3330,3330,70,0,0,0
73126,application_1508364558011_8248,1,41626,41626,73126,31500,31500,761,0,0,0
73136,application_1508364558011_32754,1,69006,69006,73136,4130,4130,72,0,0,0
73136,application_1508364558011_15153,1,45566,45566,73136,27570,27570,620,0,0,0
73156,application_1508364558011_31487,1,67646,67646,73156,5510,5510,78,0,0,0
73196,application_1508364558011_36040,1,70314,70314,73196,2882,2882,134,0,0,0
73216,application_1508364558011_2683,1,39058,39058,73216,34158,34158,871,0,0,0
73236,application_1508364558011_5764,1,40041,40041,73236,33195,33195,798,0,0,0
73246,application_1508364558011_32844,1,69116,69116,73246,4130,4130,67,0,0,0
73246,application_1508364558011_30887,1,67264,67264,73246,5982,5982,115,0,0,0
73246,application_1508364558011_32900,1,69216,69216,73246,4030,4030,60,0,0,0
73256,application_1508364558011_16448,1,46566,46566,73256,26690,26690,694,0,0,0
73266,application_1508364558011_5132,1,39862,39862,73266,33404,33404,753,0,0,0
73276,application_1508364558011_0654,1,37785,37785,73276,35491,35491,882,0,0,0
73316,application_1508364558011_19286,1,48768,48768,73316,24548,24548,662,0,0,0
73326,application_1508364558011_9448,1,42065,42065,73326,31261,31261,688,0,0,0
73346,application_1508364558011_33537,1,69516,69516,73346,3830,3830,72,0,0,0
73356,application_1506638472019_22098,1,26515,26515,73356,46841,46841,1460,0,0,0
73401,application_1506638472019_21870,1,26337,26337,73401,47064,47064,1505,0,0,0
73421,application_1508364558011_32515,1,68686,68686,73421,4735,4735,73,0,0,0
73421,application_1508364558011_16489,1,46568,46568,73421,26853,26853,643,0,0,0
73421,application_1508364558011_32674,1,68886,68886,73421,4535,4535,72,0,0,0
73471,application_1508364558011_36117,1,70364,70364,73471,3107,3107,46,0,0,0
73491,application_1508364558011_36419,1,70696,70696,73491,2795,2795,58,0,0,0
73501,application_1508364558011_31040,1,67318,67318,73501,6183,6183,193,0,0,0
73536,application_1508364558011_31794,1,68231,68231,73536,5305,5305,103,0,0,0
73572,application_1506638472019_20114,1,25176,25176,73572,48396,48396,1286,0,0,0
73572,application_1508364558011_31318,1,67466,67466,73572,6106,6106,75,0,0,0
73619,application_1508364558011_30238,1,66526,66526,73619,7093,7093,74,0,0,0
73634,application_1508364558011_5738,1,40039,40039,73634,33595,33595,747,0,0,0
73634,application_1508364558011_29697,1,66184,66184,73634,7450,7450,159,0,0,0
73664,application_1508364558011_12086,1,43471,43471,73664,30193,30193,687,0,0,0
73664,application_1508364558011_13312,1,44352,44352,73664,29312,29312,550,0,0,0
73666,application_1508364558011_7347,1,41281,41281,73666,32385,32385,840,0,0,0
73689,application_1506638472019_2811,1,13311,13311,73689,60378,60378,3317,0,0,0
73709,application_1508364558011_29187,1,65372,65372,73709,8337,8337,337,0,0,0
73729,application_1508364558011_36303,1,70556,70556,73729,3173,3173,65,0,0,0
73763,application_1508364558011_34833,1,69816,69816,73763,3947,3947,65,0,0,0
73766,application_1508364558011_32348,1,68616,68616,73766,5150,5150,64,0,0,0
73769,application_1508364558011_26519,1,58971,58971,73769,14798,14798,396,0,0,0
73782,application_1508364558011_3520,1,39239,39239,73782,34543,34543,1491,0,0,0
73805,application_1508364558011_19794,1,49201,49201,73805,24604,24604,508,0,0,0
73818,application_1508364558011_32779,1,69033,69033,73818,4785,4785,70,0,0,0
73818,application_1508364558011_35231,2,70035,70035,73818,3783,3783,16,0,0,0
73828,application_1508364558011_33684,1,69546,69546,73828,4282,4282,83,0,0,0
73838,application_1508364558011_10397,1,42150,42150,73838,31688,31688,878,0,0,0
73838,application_1508364558011_35857,2,70139,70139,73838,3699,3699,17,0,0,0
73872,application_1508364558011_35953,2,70181,70181,73872,3691,3691,29,0,0,0
73888,application_1506638472019_3449,1,13431,13431,73888,60457,60457,2891,0,0,0
73904,application_1508364558011_4283,1,39363,39363,73904,34541,34541,784,0,0,0
73919,application_1508364558011_17307,1,47396,47396,73919,26523,26523,1019,0,0,0
73933,application_1506638472019_5394,1,15892,15892,73933,58041,58041,2321,0,0,0
73963,application_1508364558011_36019,1,70276,70276,73963,3687,3687,68,0,0,0
73963,application_1508364558011_20174,1,49330,49330,73963,24633,24633,622,0,0,0
73996,application_1508364558011_8384,1,41628,41628,73996,32368,32368,690,0,0,0
74006,application_1508364558011_17681,1,47672,47672,74006,26334,26334,656,0,0,0
74012,application_1508364558011_17213,1,47314,47314,74012,26698,26698,724,0,0,0
74022,application_1508364558011_31805,1,68246,68246,74022,5776,5776,69,0,0,0
74036,application_1506638472019_38138,1,36237,36237,74036,37799,37799,890,0,0,0
74076,application_1508364558011_37055,1,72056,72056,74076,2020,2020,55,0,0,0
74096,application_1508364558011_2727,1,39060,39060,74096,35036,35036,882,0,0,0
74126,application_1508364558011_36796,1,71366,71366,74126,2760,2760,117,0,0,0
74136,application_1508364558011_4423,1,39366,39366,74136,34770,34770,735,0,0,0
74156,application_1506638472019_37963,1,36087,36087,74156,38069,38069,976,0,0,0
74156,application_1508364558011_35833,1,70086,70086,74156,4070,4070,64,0,0,0
74166,application_1508364558011_14084,1,44887,44887,74166,29279,29279,970,0,0,0
74166,application_1508364558011_22690,1,54459,54459,74166,19707,19707,443,0,0,0
74196,application_1508364558011_35202,1,69956,69956,74196,4240,4240,71,0,0,0
74196,application_1508364558011_12081,1,43471,43471,74196,30725,30725,724,0,0,0
74196,application_1508364558011_36329,1,70586,70586,74196,3610,3610,66,0,0,0
74206,application_1506638472019_38153,1,36238,36238,74206,37968,37968,901,0,0,0
74266,application_1506638472019_4512,1,15540,15540,74266,58726,58726,2542,0,0,0
74286,application_1508364558011_11296,1,43060,43060,74286,31226,31226,874,0,0,0
74306,application_1508364558011_18678,1,48011,48011,74306,26295,26295,606,0,0,0
74306,application_1508364558011_36342,1,70606,70606,74306,3700,3700,67,0,0,0
74336,application_1506638472019_19546,1,24919,24919,74336,49417,49417,1912,0,0,0
74346,application_1508364558011_9424,1,42064,42064,74346,32282,32282,716,0,0,0
74356,application_1508364558011_36031,1,70286,70286,74356,4070,4070,71,0,0,0
74391,application_1508364558011_32666,1,68876,68876,74391,5515,5515,55,0,0,0
74391,application_1508364558011_38008,1,73086,73086,74391,1305,1305,59,0,0,0
74416,application_1508364558011_17102,1,47280,47280,74416,27136,27136,548,0,0,0
74426,application_1506638472019_38161,1,36238,36238,74426,38188,38188,913,0,0,0
74436,application_1508364558011_38023,1,73146,73146,74436,1290,1290,53,0,0,0
74446,application_1508364558011_9902,1,42139,42139,74446,32307,32307,722,0,0,0
74481,application_1508364558011_7679,1,41483,41483,74481,32998,32998,885,0,0,0
74481,application_1508364558011_15270,1,45568,45568,74481,28913,28913,783,0,0,0
74521,application_1508364558011_36003,1,70246,70246,74521,4275,4275,59,0,0,0
74531,application_1508364558011_36592,1,70916,70916,74531,3615,3615,77,0,0,0
74541,application_1508364558011_32777,1,69032,69032,74541,5509,5509,83,0,0,0
74553,application_1508364558011_36905,1,71650,71650,74553,2903,2903,50,0,0,0
74553,application_1508364558011_0446,1,37559,37559,74553,36994,36994,1008,0,0,0
74583,application_1508364558011_29017,1,65256,65256,74583,9327,9327,160,0,0,0
74606,application_1508364558011_28714,1,64726,64726,74606,9880,9880,177,0,0,0
74606,application_1508364558011_7655,1,41482,41482,74606,33124,33124,789,0,0,0
74626,application_1508364558011_10553,1,42167,42167,74626,32459,32459,824,0,0,0
74626,application_1508364558011_36233,1,70456,70456,74626,4170,4170,62,0,0,0
74657,application_1506638472019_37014,1,35534,35534,74657,39123,39123,1009,0,0,0
74736,application_1508364558011_28916,1,65046,65046,74736,9690,9690,138,0,0,0
74756,application_1506638472019_6506,1,17074,17074,74756,57682,57682,2545,0,0,0
74756,application_1508364558011_36669,1,71066,71066,74756,3690,3690,54,0,0,0
74786,application_1508364558011_9103,1,41852,41852,74786,32934,32934,864,0,0,0
74792,application_1506638472019_8170,1,17296,17296,74792,57496,57496,2617,0,0,0
74812,application_1508364558011_10548,1,42167,42167,74812,32645,32645,997,0,0,0
74822,application_1508364558011_37037,1,72026,72026,74822,2796,2796,56,0,0,0
74832,application_1508364558011_33252,1,69306,69306,74832,5526,5526,98,0,0,0
74832,application_1508364558011_12446,1,43576,43576,74832,31256,31256,889,0,0,0
74842,application_1508364558011_36995,1,71916,71916,74842,2926,2926,64,0,0,0
74856,application_1508364558011_9497,1,42065,42065,74856,32791,32791,750,0,0,0
74886,application_1506638472019_21686,1,26316,26316,74886,48570,48570,1495,0,0,0
74896,application_1508364558011_31339,1,67480,67480,74896,7416,7416,110,0,0,0
74926,application_1508364558011_12058,1,43470,43470,74926,31456,31456,745,0,0,0
74936,application_1508364558011_20971,1,50266,50266,74936,24670,24670,514,0,0,0
74936,application_1508364558011_18395,1,47947,47947,74936,26989,26989,652,0,0,0
74936,application_1508364558011_4839,1,39808,39808,74936,35128,35128,754,0,0,0
74936,application_1506638472019_6815,1,17136,17136,74936,57800,57800,2451,0,0,0
74956,application_1508364558011_9501,1,42065,42065,74956,32891,32891,862,0,0,0
74956,application_1508364558011_17099,1,47280,47280,74956,27676,27676,543,0,0,0
74963,application_1508364558011_10472,1,42164,42164,74963,32799,32799,855,0,0,0
74973,application_1508364558011_20422,1,49639,49639,74973,25334,25334,492,0,0,0
74984,application_1506638472019_37962,1,36087,36087,74984,38897,38897,914,0,0,0
74984,application_1508364558011_1726,1,38785,38785,74984,36199,36199,879,0,0,0
75004,application_1508364558011_32619,1,68790,68790,75004,6214,6214,163,0,0,0
75054,application_1508364558011_37869,1,72670,72670,75054,2384,2384,66,0,0,0
75056,application_1506638472019_21734,1,26322,26322,75056,48734,48734,1460,0,0,0
75066,application_1508364558011_27884,1,62017,62017,75066,13049,13049,229,0,0,0
75076,application_1508364558011_20152,1,49328,49328,75076,25748,25748,599,0,0,0
75086,application_1508364558011_9832,1,42138,42138,75086,32948,32948,760,0,0,0
75146,application_1508364558011_36534,1,70850,70850,75146,4296,4296,62,0,0,0
75168,application_1508364558011_27552,1,60889,60889,75168,14279,14279,249,0,0,0
75188,application_1508364558011_18421,1,47948,47948,75188,27240,27240,609,0,0,0
75264,application_1508364558011_11581,1,43299,43299,75264,31965,31965,595,0,0,0
75284,application_1508364558011_33277,1,69375,69375,75284,5909,5909,91,0,0,0
75294,application_1508364558011_11163,1,42998,42998,75294,32296,32296,1033,0,0,0
75304,application_1508364558011_31795,1,68232,68232,75304,7072,7072,97,0,0,0
75333,application_1508364558011_9048,1,41851,41851,75333,33482,33482,729,0,0,0
75333,application_1506638472019_3317,1,13384,13384,75333,61949,61949,3100,0,0,0
75343,application_1508364558011_35222,1,69996,69996,75343,5347,5347,80,0,0,0
75343,application_1508364558011_36313,1,70566,70566,75343,4777,4777,67,0,0,0
75373,application_1508364558011_5150,1,39863,39863,75373,35510,35510,994,0,0,0
75373,application_1508364558011_3542,1,39240,39240,75373,36133,36133,899,0,0,0
75403,application_1508364558011_5723,1,40039,40039,75403,35364,35364,678,0,0,0
75416,application_1508364558011_18713,1,48013,48013,75416,27403,27403,643,0,0,0
75425,application_1506638472019_22705,1,26950,26950,75425,48475,48475,1589,0,0,0
75425,application_1508364558011_5359,1,39872,39872,75425,35553,35553,782,0,0,0
75425,application_1508364558011_32866,1,69146,69146,75425,6279,6279,67,0,0,0
75446,application_1508364558011_33283,1,69391,69391,75446,6055,6055,68,0,0,0
75446,application_1508364558011_33456,1,69453,69453,75446,5993,5993,128,0,0,0
75476,application_1508364558011_0385,1,37556,37556,75476,37920,37920,1013,0,0,0
75487,application_1508364558011_37977,1,73036,73036,75487,2451,2451,61,0,0,0
75487,application_1508364558011_40233,1,73848,73848,75487,1639,1639,51,0,0,0
75509,application_1508364558011_6372,1,40720,40720,75509,34789,34789,886,0,0,0
75509,application_1508364558011_11600,1,43300,43300,75509,32209,32209,714,0,0,0
75539,application_1508364558011_4790,1,39806,39806,75539,35733,35733,900,0,0,0
75562,application_1508364558011_38097,1,73536,73536,75562,2026,2026,61,0,0,0
75570,application_1506638472019_6483,1,17071,17071,75570,58499,58499,2524,0,0,0
75615,application_1506638472019_21679,1,26315,26315,75615,49300,49300,1498,0,0,0
75615,application_1508364558011_40765,1,74416,74416,75615,1199,1199,56,0,0,0
75615,application_1508364558011_36255,2,70477,70477,75615,5138,5138,12,0,0,0
75625,application_1508364558011_11754,1,43441,43441,75625,32184,32184,903,0,0,0
75625,application_1508364558011_36666,1,71056,71056,75625,4569,4569,76,0,0,0
75625,application_1508364558011_12733,8,43629,43629,75625,31996,31996,17,0,0,0
75675,application_1508364558011_37120,1,72116,72116,75675,3559,3559,65,0,0,0
75685,application_1508364558011_40592,1,73966,73966,75685,1719,1719,64,0,0,0
75685,application_1506638472019_19612,1,24929,24929,75685,50756,50756,1878,0,0,0
75685,application_1508364558011_3311,1,39219,39219,75685,36466,36466,828,0,0,0
75726,application_1506638472019_2638,1,13295,13295,75726,62431,62431,3580,0,0,0
75736,application_1506638472019_37982,1,36088,36088,75736,39648,39648,931,0,0,0
75736,application_1508364558011_30177,1,66428,66428,75736,9308,9308,235,0,0,0
75736,application_1508364558011_9076,1,41852,41852,75736,33884,33884,794,0,0,0
75754,application_1508364558011_39618,1,73756,73756,75754,1998,1998,66,0,0,0
75756,application_1508364558011_26651,1,59187,59187,75756,16569,16569,356,0,0,0
75766,application_1508364558011_11205,1,43014,43014,75766,32752,32752,873,0,0,0
75766,application_1506638472019_25294,1,27816,27816,75766,47950,47950,1395,0,0,0
75776,application_1508364558011_31122,1,67325,67325,75776,8451,8451,216,0,0,0
75786,application_1508364558011_35955,1,70186,70186,75786,5600,5600,73,0,0,0
75796,application_1508364558011_6606,1,40812,40812,75796,34984,34984,773,0,0,0
75806,application_1508364558011_25002,1,57401,57401,75806,18405,18405,309,0,0,0
75816,application_1508364558011_36728,1,71216,71216,75816,4600,4600,61,0,0,0
75816,application_1508364558011_31870,1,68366,68366,75816,7450,7450,78,0,0,0
75826,application_1508364558011_36672,1,71076,71076,75826,4750,4750,60,0,0,0
75826,application_1508364558011_0373,1,37556,37556,75826,38270,38270,1065,0,0,0
75836,application_1508364558011_32706,1,68946,68946,75836,6890,6890,64,0,0,0
75846,application_1508364558011_18428,1,47949,47949,75846,27897,27897,650,0,0,0
75886,application_1508364558011_36725,1,71206,71206,75886,4680,4680,66,0,0,0
75906,application_1508364558011_37720,1,72326,72326,75906,3580,3580,69,0,0,0
75916,application_1506638472019_20071,1,25142,25142,75916,50774,50774,1333,0,0,0
75936,application_1508364558011_31151,1,67327,67327,75936,8609,8609,187,0,0,0
75956,application_1508364558011_6620,1,40812,40812,75956,35144,35144,683,0,0,0
75966,application_1508364558011_37984,1,73056,73056,75966,2910,2910,56,0,0,0
75966,application_1508364558011_18638,1,48008,48008,75966,27958,27958,679,0,0,0
75966,application_1508364558011_36927,1,71686,71686,75966,4280,4280,64,0,0,0
75976,application_1508364558011_37032,1,72016,72016,75976,3960,3960,52,0,0,0
75996,application_1508364558011_37769,1,72346,72346,75996,3650,3650,64,0,0,0
75999,application_1508364558011_33740,1,69626,69626,75999,6373,6373,83,0,0,0
76029,application_1508364558011_37834,1,72546,72546,76029,3483,3483,61,0,0,0
76029,application_1508364558011_14251,1,44954,44954,76029,31075,31075,742,0,0,0
76029,application_1508364558011_18655,1,48009,48009,76029,28020,28020,650,0,0,0
76057,application_1508364558011_36931,1,71716,71716,76057,4341,4341,59,0,0,0
76067,application_1508364558011_9077,1,41852,41852,76067,34215,34215,833,0,0,0
76086,application_1508364558011_36576,1,70891,70891,76086,5195,5195,66,0,0,0
76115,application_1508364558011_19301,1,48769,48769,76115,27346,27346,681,0,0,0
76137,application_1508364558011_19324,1,48770,48770,76137,27367,27367,576,0,0,0
76137,application_1508364558011_30197,1,66456,66456,76137,9681,9681,273,0,0,0
76153,application_1508364558011_37086,1,72086,72086,76153,4067,4067,58,0,0,0
76206,application_1508364558011_40228,1,73844,73844,76206,2362,2362,42,0,0,0
76206,application_1508364558011_31157,1,67327,67327,76206,8879,8879,177,0,0,0
76206,application_1506638472019_22366,1,26558,26558,76206,49648,49648,1455,0,0,0
76230,application_1508364558011_40262,1,73876,73876,76230,2354,2354,53,0,0,0
76247,application_1508364558011_37041,1,72036,72036,76247,4211,4211,66,0,0,0
76251,application_1506638472019_19283,1,24861,24861,76251,51390,51390,1778,0,0,0
76251,application_1508364558011_36661,1,71046,71046,76251,5205,5205,72,0,0,0
76274,application_1506638472019_21500,1,26298,26298,76274,49976,49976,1520,0,0,0
76284,application_1508364558011_18369,1,47946,47946,76284,28338,28338,755,0,0,0
76284,application_1508364558011_11108,1,42996,42996,76284,33288,33288,930,0,0,0
76284,application_1508364558011_4924,1,39810,39810,76284,36474,36474,950,0,0,0
76284,application_1508364558011_31807,1,68251,68251,76284,8033,8033,140,0,0,0
76314,application_1506638472019_21963,1,26358,26358,76314,49956,49956,1559,0,0,0
76324,application_1508364558011_33265,1,69336,69336,76324,6988,6988,141,0,0,0
76324,application_1508364558011_31208,1,67331,67331,76324,8993,8993,193,0,0,0
76334,application_1508364558011_37851,1,72616,72616,76334,3718,3718,68,0,0,0
76344,application_1508364558011_37862,1,72658,72658,76344,3686,3686,80,0,0,0
76354,application_1508364558011_1727,1,38785,38785,76354,37569,37569,864,0,0,0
76364,application_1508364558011_2706,1,39059,39059,76364,37305,37305,847,0,0,0
76374,application_1508364558011_41040,1,74676,74676,76374,1698,1698,57,0,0,0
76384,application_1508364558011_37831,1,72526,72526,76384,3858,3858,58,0,0,0
76404,application_1508364558011_18414,1,47948,47948,76404,28456,28456,597,0,0,0
76404,application_1508364558011_40785,1,74436,74436,76404,1968,1968,51,0,0,0
76404,application_1508364558011_40663,1,74116,74116,76404,2288,2288,55,0,0,0
76476,application_1508364558011_15202,1,45567,45567,76476,30909,30909,611,0,0,0
76526,application_1508364558011_37777,1,72366,72366,76526,4160,4160,60,0,0,0
76554,application_1508364558011_8175,1,41625,41625,76554,34929,34929,875,0,0,0
76566,application_1506638472019_9044,1,17574,17574,76566,58992,58992,2470,0,0,0
76576,application_1506638472019_39069,1,37057,37057,76576,39519,39519,1100,0,0,0
76586,application_1506638472019_21360,1,26282,26282,76586,50304,50304,1473,0,0,0
76586,application_1508364558011_29307,1,65748,65748,76586,10838,10838,247,0,0,0
76606,application_1508364558011_11220,1,43015,43015,76606,33591,33591,861,0,0,0
76616,application_1506638472019_39087,1,37058,37058,76616,39558,39558,981,0,0,0
76636,application_1508364558011_36928,1,71696,71696,76636,4940,4940,64,0,0,0
76656,application_1508364558011_40601,1,73986,73986,76656,2670,2670,73,0,0,0
76678,application_1508364558011_37179,1,72246,72246,76678,4432,4432,65,0,0,0
76702,application_1508364558011_34304,1,69767,69767,76702,6935,6935,186,0,0,0
76702,application_1508364558011_12100,1,43472,43472,76702,33230,33230,566,0,0,0
76702,application_1508364558011_31012,1,67316,67316,76702,9386,9386,197,0,0,0
76757,application_1508364558011_5177,1,39863,39863,76757,36894,36894,1047,0,0,0
76757,application_1508364558011_33773,1,69686,69686,76757,7071,7071,78,0,0,0
76777,application_1508364558011_3908,1,39297,39297,76777,37480,37480,912,0,0,0
76787,application_1508364558011_41961,1,75576,75576,76787,1211,1211,54,0,0,0
76803,application_1508364558011_0458,1,37559,37559,76803,39244,39244,992,0,0,0
76856,application_1508364558011_40694,1,74236,74236,76856,2620,2620,61,0,0,0
76874,application_1508364558011_14464,1,45028,45028,76874,31846,31846,699,0,0,0
76874,application_1508364558011_37024,1,71986,71986,76874,4888,4888,59,0,0,0
76874,application_1508364558011_32911,1,69225,69225,76874,7649,7649,129,0,0,0
76887,application_1508364558011_34895,1,69864,69864,76887,7023,7023,234,0,0,0
76887,application_1508364558011_37356,1,72296,72296,76887,4591,4591,59,0,0,0
76897,application_1508364558011_7174,1,41278,41278,76897,35619,35619,1664,0,0,0
76917,application_1508364558011_36597,1,70927,70927,76917,5990,5990,84,0,0,0
76930,application_1508364558011_11838,1,43444,43444,76930,33486,33486,895,0,0,0
76940,application_1508364558011_37848,1,72606,72606,76940,4334,4334,59,0,0,0
76950,application_1508364558011_42367,4,76264,76264,76950,686,686,19,0,0,0
76976,application_1508364558011_42168,1,75999,75999,76976,977,977,41,0,0,0
76985,application_1506638472019_21498,1,26298,26298,76985,50687,50687,1474,0,0,0
76997,application_1508364558011_41922,1,75546,75546,76997,1451,1451,53,0,0,0
77046,application_1508364558011_20166,1,49329,49329,77046,27717,27717,625,0,0,0
77046,application_1508364558011_32518,1,68693,68693,77046,8353,8353,162,0,0,0
77056,application_1506638472019_22119,1,26518,26518,77056,50538,50538,1580,0,0,0
77066,application_1508364558011_37161,1,72196,72196,77066,4870,4870,67,0,0,0
77066,application_1508364558011_40597,1,73976,73976,77066,3090,3090,63,0,0,0
77086,application_1508364558011_11768,1,43441,43441,77086,33645,33645,870,0,0,0
77096,application_1508364558011_32708,1,68947,68947,77096,8149,8149,118,0,0,0
77096,application_1508364558011_31005,1,67316,67316,77096,9780,9780,210,0,0,0
77096,application_1508364558011_33787,1,69689,69689,77096,7407,7407,930,0,0,0
77106,application_1506638472019_38131,1,36237,36237,77106,40869,40869,888,0,0,0
77106,application_1508364558011_33720,1,69605,69605,77106,7501,7501,133,0,0,0
77148,application_1508364558011_31602,1,67856,67856,77148,9292,9292,172,0,0,0
77186,application_1508364558011_38027,1,73166,73166,77186,4020,4020,63,0,0,0
77186,application_1508364558011_26916,4,59584,59584,77186,17602,17602,59,0,0,0
77196,application_1508364558011_42058,1,75796,75796,77196,1400,1400,58,0,0,0
77216,application_1508364558011_41439,1,74846,74846,77216,2370,2370,60,0,0,0
77216,application_1506638472019_22017,1,26364,26364,77216,50852,50852,1468,0,0,0
77216,application_1508364558011_41537,1,75056,75056,77216,2160,2160,57,0,0,0
77236,application_1508364558011_2406,1,39009,39009,77236,38227,38227,892,0,0,0
77276,application_1508364558011_41064,1,74706,74706,77276,2570,2570,67,0,0,0
77286,application_1508364558011_16452,1,46566,46566,77286,30720,30720,722,0,0,0
77306,application_1506638472019_21516,1,26299,26299,77306,51007,51007,1557,0,0,0
77306,application_1508364558011_37163,4,72202,72202,77306,5104,5104,192,0,0,0
77323,application_1508364558011_7673,1,41483,41483,77323,35840,35840,810,0,0,0
77333,application_1508364558011_40726,1,74336,74336,77333,2997,2997,56,0,0,0
77333,application_1508364558011_37804,1,72446,72446,77333,4887,4887,69,0,0,0
77340,application_1506638472019_2797,1,13310,13310,77340,64030,64030,2762,0,0,0
77350,application_1508364558011_43003,1,76987,76987,77350,363,363,15,0,0,0
77350,application_1508364558011_36679,1,71106,71106,77350,6244,6244,63,0,0,0
77370,application_1508364558011_3498,1,39238,39238,77370,38132,38132,898,0,0,0
77380,application_1508364558011_41475,1,74936,74936,77380,2444,2444,66,0,0,0
77400,application_1508364558011_36449,1,70721,70721,77400,6679,6679,115,0,0,0
77406,application_1508364558011_27523,1,60803,60803,77406,16603,16603,352,0,0,0
77426,application_1508364558011_41401,1,74792,74792,77426,2634,2634,69,0,0,0
77436,application_1506638472019_7889,1,17268,17268,77436,60168,60168,2628,0,0,0
77446,application_1508364558011_34309,1,69767,69767,77446,7679,7679,186,0,0,0
77456,application_1506638472019_21669,1,26314,26314,77456,51142,51142,1532,0,0,0
77456,application_1508364558011_36365,1,70626,70626,77456,6830,6830,62,0,0,0
77456,application_1508364558011_36998,1,71926,71926,77456,5530,5530,75,0,0,0
77476,application_1508364558011_0424,1,37558,37558,77476,39918,39918,944,0,0,0
77486,application_1508364558011_40715,1,74306,74306,77486,3180,3180,65,0,0,0
77499,application_1508364558011_36128,1,70391,70391,77499,7108,7108,58,0,0,0
77529,application_1508364558011_36797,2,71366,71366,77529,6163,6163,126,0,0,0
77535,application_1508364558011_7288,1,41280,41280,77535,36255,36255,900,0,0,0
77576,application_1508364558011_18737,1,48015,48015,77576,29561,29561,688,0,0,0
77576,application_1508364558011_36649,1,71034,71034,77576,6542,6542,130,0,0,0
77606,application_1508364558011_41637,1,75215,75215,77606,2391,2391,75,0,0,0
77616,application_1508364558011_0596,1,37718,37718,77616,39898,39898,866,0,0,0
77619,application_1508364558011_29041,1,65295,65295,77619,12324,12324,258,0,0,0
77619,application_1508364558011_6685,1,40813,40813,77619,36806,36806,988,0,0,0
77629,application_1508364558011_37860,1,72656,72656,77629,4973,4973,60,0,0,0
77629,application_1508364558011_34930,1,69867,69867,77629,7762,7762,187,0,0,0
77629,application_1508364558011_7398,1,41282,41282,77629,36347,36347,933,0,0,0
77646,application_1506638472019_21749,1,26323,26323,77646,51323,51323,1503,0,0,0
77646,application_1508364558011_36798,2,71366,71366,77646,6280,6280,112,0,0,0
77663,application_1508364558011_36898,2,71621,71621,77663,6042,6042,11,0,0,0
77686,application_1508364558011_37067,2,72064,72064,77686,5622,5622,15,0,0,0
77696,application_1508364558011_5187,1,39864,39864,77696,37832,37832,733,0,0,0
77717,application_1506638472019_6832,1,17138,17138,77717,60579,60579,2481,0,0,0
77726,application_1508364558011_10993,1,42907,42907,77726,34819,34819,1317,0,0,0
77726,application_1508364558011_43081,1,77156,77156,77726,570,570,56,0,0,0
77756,application_1508364558011_39485,1,73666,73666,77756,4090,4090,60,0,0,0
77756,application_1508364558011_16081,4,46385,46385,77756,31371,31371,59,0,0,0
77766,application_1506638472019_22234,1,26531,26531,77766,51235,51235,1555,0,0,0
77843,application_1508364558011_37969,1,73003,73003,77843,4840,4840,115,0,0,0
77850,application_1506638472019_22417,1,26564,26564,77850,51286,51286,1480,0,0,0
77880,application_1508364558011_41043,1,74683,74683,77880,3197,3197,72,0,0,0
77890,application_1506638472019_21786,1,26327,26327,77890,51563,51563,1570,0,0,0
77890,application_1506638472019_18269,1,24567,24567,77890,53323,53323,2250,0,0,0
77903,application_1506638472019_22003,1,26362,26362,77903,51541,51541,1563,0,0,0
77916,application_1508364558011_29985,1,66230,66230,77916,11686,11686,308,0,0,0
77944,application_1508364558011_3701,1,39257,39257,77944,38687,38687,827,0,0,0
77954,application_1508364558011_42022,1,75716,75716,77954,2238,2238,57,0,0,0
77964,application_1508364558011_31108,1,67325,67325,77964,10639,10639,184,0,0,0
78076,application_1506638472019_22335,1,26542,26542,78076,51534,51534,1540,0,0,0
78079,application_1508364558011_31477,1,67640,67640,78079,10439,10439,241,0,0,0
78089,application_1508364558011_1706,1,38784,38784,78089,39305,39305,860,0,0,0
78131,application_1508364558011_2710,1,39059,39059,78131,39072,39072,1041,0,0,0
78131,application_1508364558011_29908,1,66220,66220,78131,11911,11911,318,0,0,0
78131,application_1506638472019_22420,1,26565,26565,78131,51566,51566,1463,0,0,0
78143,application_1508364558011_4370,1,39365,39365,78143,38778,38778,911,0,0,0
78160,application_1508364558011_31069,1,67320,67320,78160,10840,10840,192,0,0,0
78175,application_1508364558011_42318,1,76216,76216,78175,1959,1959,27,0,0,0
78181,application_1508364558011_42035,1,75756,75756,78181,2425,2425,58,0,0,0
78181,application_1508364558011_22057,1,52241,52241,78181,25940,25940,522,0,0,0
78195,application_1508364558011_31116,1,67325,67325,78195,10870,10870,194,0,0,0
78195,application_1508364558011_18424,1,47949,47949,78195,30246,30246,595,0,0,0
78213,application_1508364558011_1976,1,38856,38856,78213,39357,39357,797,0,0,0
78221,application_1508364558011_14254,1,44954,44954,78221,33267,33267,745,0,0,0
78231,application_1508364558011_29757,1,66195,66195,78231,12036,12036,333,0,0,0
78235,application_1508364558011_31853,1,68312,68312,78235,9923,9923,173,0,0,0
78247,application_1508364558011_41852,1,75477,75477,78247,2770,2770,96,0,0,0
78276,application_1508364558011_18383,1,47947,47947,78276,30329,30329,670,0,0,0
78308,application_1508364558011_37157,1,72186,72186,78308,6122,6122,62,0,0,0
78318,application_1508364558011_42322,1,76218,76218,78318,2100,2100,48,0,0,0
78318,application_1508364558011_2043,1,38858,38858,78318,39460,39460,967,0,0,0
78318,application_1508364558011_31207,1,67331,67331,78318,10987,10987,172,0,0,0
78324,application_1506638472019_21788,1,26328,26328,78324,51996,51996,1499,0,0,0
78324,application_1508364558011_42321,1,76218,76218,78324,2106,2106,30,0,0,0
78335,application_1508364558011_13845,1,44699,44699,78335,33636,33636,722,0,0,0
78386,application_1508364558011_18643,1,48008,48008,78386,30378,30378,685,0,0,0
78386,application_1508364558011_37787,2,72400,72400,78386,5986,5986,21,0,0,0
78396,application_1508364558011_40092,16,73799,73799,78396,4597,4597,35,0,0,0
78409,application_1508364558011_9910,1,42139,42139,78409,36270,36270,855,0,0,0
78409,application_1508364558011_13060,1,43948,43948,78409,34461,34461,773,0,0,0
78466,application_1508364558011_21175,1,50537,50537,78466,27929,27929,695,0,0,0
78496,application_1508364558011_41792,1,75436,75436,78496,3060,3060,69,0,0,0
78496,application_1508364558011_9858,1,42138,42138,78496,36358,36358,861,0,0,0
78496,application_1508364558011_29975,1,66229,66229,78496,12267,12267,322,0,0,0
78496,application_1506638472019_7759,1,17257,17257,78496,61239,61239,2515,0,0,0
78516,application_1508364558011_17721,4,47745,47745,78516,30771,30771,185,0,0,0
78549,application_1508364558011_3474,1,39236,39236,78549,39313,39313,919,0,0,0
78549,application_1508364558011_44076,1,78079,78079,78549,470,470,22,0,0,0
78559,application_1506638472019_24430,1,27664,27664,78559,50895,50895,1401,0,0,0
78564,application_1508364558011_39907,1,73781,73781,78564,4783,4783,181,0,0,0
78586,application_1508364558011_5474,1,39943,39943,78586,38643,38643,842,0,0,0
78596,application_1508364558011_3535,1,39240,39240,78596,39356,39356,854,0,0,0
78596,application_1508364558011_7672,1,41483,41483,78596,37113,37113,763,0,0,0
78630,application_1508364558011_21699,4,51026,51026,78630,27604,27604,75,0,0,0
78651,application_1508364558011_1998,1,38857,38857,78651,39794,39794,1100,0,0,0
78651,application_1506638472019_21851,1,26334,26334,78651,52317,52317,1568,0,0,0
78651,application_1506638472019_21697,1,26317,26317,78651,52334,52334,1470,0,0,0
78666,application_1506638472019_39107,1,37059,37059,78666,41607,41607,999,0,0,0
78666,application_1508364558011_41703,1,75306,75306,78666,3360,3360,58,0,0,0
78676,application_1508364558011_20158,1,49328,49328,78676,29348,29348,611,0,0,0
78686,application_1508364558011_10969,1,42905,42905,78686,35781,35781,918,0,0,0
78686,application_1508364558011_15532,1,45846,45846,78686,32840,32840,853,0,0,0
78706,application_1508364558011_19850,1,49206,49206,78706,29500,29500,718,0,0,0
78726,application_1506638472019_22093,1,26514,26514,78726,52212,52212,1514,0,0,0
78736,application_1508364558011_20191,1,49331,49331,78736,29405,29405,555,0,0,0
78736,application_1508364558011_40990,1,74596,74596,78736,4140,4140,57,0,0,0
78766,application_1508364558011_42052,1,75776,75776,78766,2990,2990,53,0,0,0
78766,application_1506638472019_31012,1,31074,31074,78766,47692,47692,1964,0,0,0
78776,application_1508364558011_42694,1,76686,76686,78776,2090,2090,77,0,0,0
78786,application_1508364558011_41787,1,75425,75425,78786,3361,3361,47,0,0,0
78806,application_1508364558011_43032,1,77056,77056,78806,1750,1750,68,0,0,0
78846,application_1508364558011_31048,1,67319,67319,78846,11527,11527,252,0,0,0
78886,application_1508364558011_42936,1,76877,76877,78886,2009,2009,56,0,0,0
78916,application_1508364558011_44398,1,78153,78153,78916,763,763,39,0,0,0
78947,application_1508364558011_42205,1,76036,76036,78947,2911,2911,50,0,0,0
78947,application_1506638472019_19172,1,24842,24842,78947,54105,54105,1844,0,0,0
78957,application_1508364558011_34316,1,69768,69768,78957,9189,9189,210,0,0,0
78967,application_1508364558011_31191,1,67330,67330,78967,11637,11637,190,0,0,0
78967,application_1508364558011_41723,1,75333,75333,78967,3634,3634,79,0,0,0
78997,application_1508364558011_41391,1,74776,74776,78997,4221,4221,73,0,0,0
79007,application_1508364558011_42208,1,76046,76046,79007,2961,2961,59,0,0,0
79047,application_1508364558011_10963,1,42905,42905,79047,36142,36142,860,0,0,0
79057,application_1508364558011_5486,1,39967,39967,79057,39090,39090,1070,0,0,0
79057,application_1508364558011_43027,1,77036,77036,79057,2021,2021,59,0,0,0
79064,application_1508364558011_42540,1,76606,76606,79064,2458,2458,56,0,0,0
79086,application_1506638472019_7493,1,17223,17223,79086,61863,61863,2466,0,0,0
79086,application_1508364558011_10340,1,42149,42149,79086,36937,36937,918,0,0,0
79135,application_1508364558011_43133,1,77216,77216,79135,1919,1919,51,0,0,0
79135,application_1508364558011_41809,1,75464,75464,79135,3671,3671,87,0,0,0
79135,application_1508364558011_11863,1,43445,43445,79135,35690,35690,887,0,0,0
79152,application_1508364558011_14235,1,44953,44953,79152,34199,34199,761,0,0,0
79178,application_1508364558011_41600,1,75158,75158,79178,4020,4020,102,0,0,0
79188,application_1508364558011_4856,1,39809,39809,79188,39379,39379,1029,0,0,0
79188,application_1508364558011_43135,1,77226,77226,79188,1962,1962,60,0,0,0
79188,application_1508364558011_41559,1,75076,75076,79188,4112,4112,60,0,0,0
79198,application_1508364558011_41443,1,74856,74856,79198,4342,4342,60,0,0,0
79212,application_1508364558011_36144,1,70439,70439,79212,8773,8773,123,0,0,0
79229,application_1508364558011_28678,1,64696,64696,79229,14533,14533,127,0,0,0
79239,application_1508364558011_39059,1,73616,73616,79239,5623,5623,101,0,0,0
79243,application_1508364558011_13056,1,43947,43947,79243,35296,35296,839,0,0,0
79253,application_1506638472019_22327,1,26541,26541,79253,52712,52712,1473,0,0,0
79253,application_1508364558011_10447,1,42151,42151,79253,37102,37102,831,0,0,0
79268,application_1508364558011_37413,1,72302,72302,79268,6966,6966,185,0,0,0
79286,application_1508364558011_33251,1,69306,69306,79286,9980,9980,177,0,0,0
79310,application_1506638472019_21401,1,26287,26287,79310,53023,53023,1576,0,0,0
79310,application_1508364558011_3027,1,39131,39131,79310,40179,40179,1190,0,0,0
79330,application_1508364558011_5810,1,40041,40041,79330,39289,39289,842,0,0,0
79340,application_1506638472019_22358,1,26557,26557,79340,52783,52783,1478,0,0,0
79360,application_1508364558011_12405,1,43574,43574,79360,35786,35786,880,0,0,0
79370,application_1506638472019_3039,1,13363,13363,79370,66007,66007,3144,0,0,0
79396,application_1508364558011_34861,1,69860,69860,79396,9536,9536,185,0,0,0
79416,application_1508364558011_43127,1,77206,77206,79416,2210,2210,54,0,0,0
79426,application_1508364558011_29951,1,66225,66225,79426,13201,13201,334,0,0,0
79446,application_1508364558011_2602,1,39028,39028,79446,40418,40418,804,0,0,0
79470,application_1508364558011_9449,1,42065,42065,79470,37405,37405,896,0,0,0
79507,application_1508364558011_45729,1,78576,78576,79507,931,931,65,0,0,0
79507,application_1508364558011_10487,1,42164,42164,79507,37343,37343,811,0,0,0
79507,application_1508364558011_16706,8,46766,46766,79507,32741,32741,179,0,0,0
79510,application_1508364558011_40538,1,73919,73919,79510,5591,5591,117,0,0,0
79520,application_1508364558011_42457,1,76426,76426,79520,3094,3094,49,0,0,0
79564,application_1508364558011_29759,1,66196,66196,79564,13368,13368,356,0,0,0
79574,application_1508364558011_28697,1,64705,64705,79574,14869,14869,331,0,0,0
79602,application_1508364558011_45762,1,78641,78641,79602,961,961,28,0,0,0
79612,application_1508364558011_39932,1,73783,73783,79612,5829,5829,177,0,0,0
79612,application_1508364558011_20456,1,49643,49643,79612,29969,29969,470,0,0,0
79622,application_1508364558011_31053,1,67319,67319,79622,12303,12303,205,0,0,0
79632,application_1508364558011_18721,1,48014,48014,79632,31618,31618,723,0,0,0
79642,application_1508364558011_30856,1,67234,67234,79642,12408,12408,161,0,0,0
79674,application_1508364558011_46706,1,79644,79644,79674,30,30,10,0,0,0
79674,application_1508364558011_44440,1,78156,78156,79674,1518,1518,71,0,0,0
79684,application_1508364558011_4215,1,39362,39362,79684,40322,40322,952,0,0,0
79694,application_1508364558011_41851,1,75477,75477,79694,4217,4217,102,0,0,0
79704,application_1508364558011_16718,8,46769,46769,79704,32935,32935,190,0,0,0
79714,application_1506638472019_29382,1,30000,30000,79714,49714,49714,1145,0,0,0
79766,application_1506638472019_21392,1,26286,26286,79766,53480,53480,1580,0,0,0
79776,application_1506638472019_6560,1,17079,17079,79776,62697,62697,2449,0,0,0
79786,application_1508364558011_43225,1,77446,77446,79786,2340,2340,57,0,0,0
79796,application_1508364558011_19284,1,48768,48768,79796,31028,31028,612,0,0,0
79835,application_1508364558011_6686,1,40813,40813,79835,39022,39022,847,0,0,0
79850,application_1508364558011_16445,1,46566,46566,79850,33284,33284,742,0,0,0
79850,application_1508364558011_31055,1,67320,67320,79850,12530,12530,303,0,0,0
79875,application_1508364558011_33724,1,69611,69611,79875,10264,10264,182,0,0,0
79885,application_1508364558011_31115,1,67325,67325,79885,12560,12560,190,0,0,0
79898,application_1508364558011_41924,1,75562,75562,79898,4336,4336,62,0,0,0
79908,application_1506638472019_6927,1,17148,17148,79908,62760,62760,2569,0,0,0
79918,application_1508364558011_10600,1,42169,42169,79918,37749,37749,1005,0,0,0
79923,application_1508364558011_32893,1,69198,69198,79923,10725,10725,466,0,0,0
79953,application_1508364558011_42277,1,76156,76156,79953,3797,3797,53,0,0,0
79958,application_1506638472019_21655,1,26312,26312,79958,53646,53646,1477,0,0,0
79958,application_1508364558011_29957,1,66226,66226,79958,13732,13732,323,0,0,0
79978,application_1508364558011_32668,1,68882,68882,79978,11096,11096,133,0,0,0
79988,application_1508364558011_41864,1,75479,75479,79988,4509,4509,100,0,0,0
79988,application_1508364558011_45646,1,78386,78386,79988,1602,1602,58,0,0,0
80006,application_1508364558011_29984,1,66230,66230,80006,13776,13776,348,0,0,0
80006,application_1508364558011_1068,4,38246,38246,80006,41760,41760,128,0,0,0
80016,application_1508364558011_41772,1,75406,75406,80016,4610,4610,72,0,0,0
80016,application_1508364558011_42309,1,76211,76211,80016,3805,3805,76,0,0,0
80016,application_1508364558011_21579,1,50816,50816,80016,29200,29200,639,0,0,0
80076,application_1506638472019_28837,1,29291,29291,80076,50785,50785,1281,0,0,0
80086,application_1508364558011_29486,1,66066,66066,80086,14020,14020,242,0,0,0
80106,application_1506638472019_3149,1,13372,13372,80106,66734,66734,2851,0,0,0
80175,application_1508364558011_3249,1,39217,39217,80175,40958,40958,926,0,0,0
80200,application_1508364558011_12409,1,43574,43574,80200,36626,36626,898,0,0,0
80220,application_1508364558011_43467,1,77786,77786,80220,2434,2434,65,0,0,0
80230,application_1508364558011_9155,1,41853,41853,80230,38377,38377,1034,0,0,0
80240,application_1508364558011_4254,1,39363,39363,80240,40877,40877,934,0,0,0
80240,application_1508364558011_43416,1,77720,77720,80240,2520,2520,31,0,0,0
80240,application_1508364558011_45397,1,78276,78276,80240,1964,1964,65,0,0,0
80240,application_1508364558011_46931,1,79933,79933,80240,307,307,17,0,0,0
80251,application_1506638472019_6669,1,17094,17094,80251,63157,63157,2553,0,0,0
80251,application_1508364558011_46260,1,79202,79202,80251,1049,1049,32,0,0,0
80262,application_1508364558011_42992,1,76976,76976,80262,3286,3286,51,0,0,0
80279,application_1506638472019_22269,1,26535,26535,80279,53744,53744,1506,0,0,0
80279,application_1508364558011_5776,1,40041,40041,80279,40238,40238,1063,0,0,0
80289,application_1508364558011_8286,1,41626,41626,80289,38663,38663,687,0,0,0
80289,application_1508364558011_41880,1,75488,75488,80289,4801,4801,123,0,0,0
80306,application_1506638472019_24421,1,27653,27653,80306,52653,52653,1349,0,0,0
80306,application_1508364558011_14209,1,44952,44952,80306,35354,35354,718,0,0,0
80316,application_1508364558011_43369,1,77646,77646,80316,2670,2670,72,0,0,0
80326,application_1508364558011_44049,1,78046,78046,80326,2280,2280,47,0,0,0
80326,application_1508364558011_15228,1,45567,45567,80326,34759,34759,826,0,0,0
80356,application_1506638472019_7207,1,17164,17164,80356,63192,63192,2474,0,0,0
80376,application_1508364558011_35248,1,70061,70061,80376,10315,10315,189,0,0,0
80406,application_1508364558011_42726,1,76696,76696,80406,3710,3710,56,0,0,0
80406,application_1508364558011_35258,1,70061,70061,80406,10345,10345,173,0,0,0
80416,application_1508364558011_44843,1,78216,78216,80416,2200,2200,80,0,0,0
80416,application_1508364558011_9467,1,42065,42065,80416,38351,38351,1006,0,0,0
80416,application_1508364558011_46122,1,79107,79107,80416,1309,1309,29,0,0,0
80426,application_1508364558011_46954,1,79953,79953,80426,473,473,19,0,0,0
80426,application_1508364558011_31124,1,67325,67325,80426,13101,13101,223,0,0,0
80436,application_1506638472019_9885,1,17826,17826,80436,62610,62610,1739,0,0,0
80454,application_1508364558011_31042,1,67319,67319,80454,13135,13135,277,0,0,0
80454,application_1508364558011_45920,1,78917,78917,80454,1537,1537,33,0,0,0
80454,application_1508364558011_45416,1,78306,78306,80454,2148,2148,62,0,0,0
80485,application_1506638472019_5396,1,15892,15892,80485,64593,64593,2552,0,0,0
80485,application_1506638472019_7855,1,17265,17265,80485,63220,63220,2695,0,0,0
80485,application_1508364558011_42386,1,76286,76286,80485,4199,4199,57,0,0,0
80495,application_1506638472019_21841,1,26333,26333,80495,54162,54162,1559,0,0,0
80521,application_1508364558011_1693,1,38783,38783,80521,41738,41738,1012,0,0,0
80521,application_1508364558011_11774,1,43441,43441,80521,37080,37080,889,0,0,0
80521,application_1508364558011_14556,4,45145,45145,80521,35376,35376,90,0,0,0
80550,application_1508364558011_43065,1,77118,77118,80550,3432,3432,82,0,0,0
80556,application_1508364558011_41817,1,75465,75465,80556,5091,5091,89,0,0,0
80568,application_1508364558011_19338,1,48771,48771,80568,31797,31797,641,0,0,0
80601,application_1508364558011_35260,1,70061,70061,80601,10540,10540,222,0,0,0
80606,application_1508364558011_31229,1,67332,67332,80606,13274,13274,214,0,0,0
80666,application_1506638472019_6877,1,17145,17145,80666,63521,63521,2503,0,0,0
80676,application_1506638472019_22277,1,26536,26536,80676,54140,54140,1552,0,0,0
80676,application_1506638472019_6762,1,17130,17130,80676,63546,63546,2634,0,0,0
80676,application_1508364558011_46628,1,79589,79589,80676,1087,1087,15,0,0,0
80689,application_1508364558011_12408,1,43574,43574,80689,37115,37115,883,0,0,0
80699,application_1508364558011_3812,1,39290,39290,80699,41409,41409,1586,0,0,0
80709,application_1506638472019_37983,1,36088,36088,80709,44621,44621,866,0,0,0
80729,application_1508364558011_11152,1,42997,42997,80729,37732,37732,943,0,0,0
80729,application_1508364558011_27006,4,59727,59727,80729,21002,21002,63,0,0,0
80736,application_1506638472019_21356,1,26281,26281,80736,54455,54455,1573,0,0,0
80751,application_1508364558011_20215,1,49332,49332,80751,31419,31419,636,0,0,0
80751,application_1508364558011_41846,1,75477,75477,80751,5274,5274,112,0,0,0
80771,application_1508364558011_37225,1,72286,72286,80771,8485,8485,223,0,0,0
80771,application_1506638472019_19497,1,24909,24909,80771,55862,55862,1870,0,0,0
80791,application_1506638472019_6452,1,17067,17067,80791,63724,63724,2494,0,0,0
80796,application_1508364558011_2387,1,39007,39007,80796,41789,41789,1181,0,0,0
80816,application_1508364558011_42216,1,76076,76076,80816,4740,4740,62,0,0,0
80816,application_1508364558011_29801,1,66204,66204,80816,14612,14612,330,0,0,0
80826,application_1508364558011_11319,1,43061,43061,80826,37765,37765,897,0,0,0
80859,application_1508364558011_46962,1,79958,79958,80859,901,901,25,0,0,0
80916,application_1506638472019_21968,1,26358,26358,80916,54558,54558,1537,0,0,0
80916,application_1508364558011_44770,1,78191,78191,80916,2725,2725,95,0,0,0
80958,application_1508364558011_45791,1,78726,78726,80958,2232,2232,64,0,0,0
80958,application_1508364558011_37426,1,72303,72303,80958,8655,8655,212,0,0,0
80978,application_1508364558011_43206,1,77406,77406,80978,3572,3572,66,0,0,0
80984,application_1508364558011_4243,1,39363,39363,80984,41621,41621,1065,0,0,0
81014,application_1508364558011_38884,1,73603,73603,81014,7411,7411,186,0,0,0
81024,application_1506638472019_18008,1,24513,24513,81024,56511,56511,2037,0,0,0
81024,application_1508364558011_42935,1,76876,76876,81024,4148,4148,61,0,0,0
81034,application_1506638472019_21903,1,26341,26341,81034,54693,54693,1553,0,0,0
81044,application_1506638472019_19300,1,24865,24865,81044,56179,56179,1881,0,0,0
81052,application_1508364558011_43280,1,77556,77556,81052,3496,3496,120,0,0,0
81052,application_1508364558011_42209,1,76047,76047,81052,5005,5005,95,0,0,0
81062,application_1508364558011_37577,1,72315,72315,81062,8747,8747,255,0,0,0
81072,application_1508364558011_7238,1,41279,41279,81072,39793,39793,942,0,0,0
81082,application_1508364558011_35250,1,70061,70061,81082,11021,11021,206,0,0,0
81082,application_1508364558011_12119,1,43473,43473,81082,37609,37609,740,0,0,0
81092,application_1508364558011_29958,1,66226,66226,81092,14866,14866,366,0,0,0
81102,application_1508364558011_14244,1,44953,44953,81102,36149,36149,736,0,0,0
81102,application_1508364558011_44773,1,78192,78192,81102,2910,2910,93,0,0,0
81122,application_1506638472019_12372,1,18868,18868,81122,62254,62254,2101,0,0,0
81132,application_1508364558011_5149,1,39863,39863,81132,41269,41269,1158,0,0,0
81152,application_1508364558011_44780,1,78193,78193,81152,2959,2959,83,0,0,0
81166,application_1508364558011_39626,1,73757,73757,81166,7409,7409,170,0,0,0
81197,application_1508364558011_41896,1,75489,75489,81197,5708,5708,122,0,0,0
81197,application_1506638472019_7531,1,17227,17227,81197,63970,63970,2440,0,0,0
81237,application_1506638472019_12258,1,18851,18851,81237,62386,62386,1990,0,0,0
81296,application_1506638472019_22223,1,26530,26530,81296,54766,54766,1482,0,0,0
81316,application_1508364558011_46060,1,79086,79086,81316,2230,2230,65,0,0,0
81336,application_1508364558011_29913,1,66220,66220,81336,15116,15116,360,0,0,0
81366,application_1508364558011_41901,1,75490,75490,81366,5876,5876,100,0,0,0
81366,application_1508364558011_46057,1,79075,79075,81366,2291,2291,63,0,0,0
81376,application_1508364558011_45901,1,78896,78896,81376,2480,2480,63,0,0,0
81376,application_1508364558011_20976,1,50266,50266,81376,31110,31110,813,0,0,0
81376,application_1508364558011_41465,1,74906,74906,81376,6470,6470,72,0,0,0
81386,application_1508364558011_2658,1,39057,39057,81386,42329,42329,1020,0,0,0
81406,application_1506638472019_21986,1,26360,26360,81406,55046,55046,1451,0,0,0
81418,application_1508364558011_29700,1,66186,66186,81418,15232,15232,343,0,0,0
81458,application_1508364558011_33783,1,69688,69688,81458,11770,11770,315,0,0,0
81468,application_1508364558011_34910,1,69866,69866,81468,11602,11602,218,0,0,0
81468,application_1508364558011_46363,1,79286,79286,81468,2182,2182,65,0,0,0
81478,application_1508364558011_37354,1,72296,72296,81478,9182,9182,203,0,0,0
81488,application_1508364558011_42391,1,76294,76294,81488,5194,5194,58,0,0,0
81488,application_1506638472019_10738,1,18637,18637,81488,62851,62851,2313,0,0,0
81508,application_1508364558011_21395,1,50725,50725,81508,30783,30783,642,0,0,0
81548,application_1508364558011_6736,1,40814,40814,81548,40734,40734,1043,0,0,0
81568,application_1508364558011_45691,1,78516,78516,81568,3052,3052,60,0,0,0
81578,application_1508364558011_11158,1,42998,42998,81578,38580,38580,901,0,0,0
81578,application_1508364558011_44902,1,78225,78225,81578,3353,3353,120,0,0,0
81588,application_1508364558011_39076,1,73618,73618,81588,7970,7970,207,0,0,0
81588,application_1508364558011_41905,1,75492,75492,81588,6096,6096,110,0,0,0
81618,application_1508364558011_40177,1,73806,73806,81618,7812,7812,226,0,0,0
81628,application_1508364558011_43059,1,77106,77106,81628,4522,4522,60,0,0,0
81638,application_1508364558011_44806,1,78199,78199,81638,3439,3439,102,0,0,0
81648,application_1508364558011_35256,1,70061,70061,81648,11587,11587,224,0,0,0
81648,application_1508364558011_47195,1,80346,80346,81648,1302,1302,61,0,0,0
81658,application_1508364558011_18370,1,47946,47946,81658,33712,33712,779,0,0,0
81668,application_1508364558011_11170,1,43013,43013,81668,38655,38655,882,0,0,0
81678,application_1508364558011_21681,1,50965,50965,81678,30713,30713,671,0,0,0
81708,application_1508364558011_46353,1,79276,79276,81708,2432,2432,66,0,0,0
81718,application_1508364558011_41877,1,75487,75487,81718,6231,6231,95,0,0,0
81718,application_1508364558011_9073,1,41852,41852,81718,39866,39866,927,0,0,0
81738,application_1508364558011_41964,1,75596,75596,81738,6142,6142,62,0,0,0
81750,application_1508364558011_10356,1,42149,42149,81750,39601,39601,899,0,0,0
81770,application_1508364558011_41830,1,75466,75466,81770,6304,6304,75,0,0,0
81770,application_1506638472019_22095,1,26515,26515,81770,55255,55255,1592,0,0,0
81776,application_1508364558011_45915,1,78916,78916,81776,2860,2860,67,0,0,0
81796,application_1506638472019_21823,1,26331,26331,81796,55465,55465,1511,0,0,0
81796,application_1508364558011_44918,1,78226,78226,81796,3570,3570,102,0,0,0
81806,application_1508364558011_44784,1,78193,78193,81806,3613,3613,84,0,0,0
81806,application_1508364558011_31165,1,67328,67328,81806,14478,14478,187,0,0,0
81816,application_1508364558011_34293,1,69766,69766,81816,12050,12050,222,0,0,0
81826,application_1508364558011_41955,1,75570,75570,81826,6256,6256,162,0,0,0
81826,application_1508364558011_0418,1,37557,37557,81826,44269,44269,848,0,0,0
81826,application_1508364558011_14559,4,45146,45146,81826,36680,36680,84,0,0,0
81826,application_1508364558011_21700,4,51026,51026,81826,30800,30800,67,0,0,0
81846,application_1506638472019_22096,1,26515,26515,81846,55331,55331,1546,0,0,0
81858,application_1508364558011_44240,1,78131,78131,81858,3727,3727,62,0,0,0
81868,application_1508364558011_11321,1,43061,43061,81868,38807,38807,915,0,0,0
81878,application_1508364558011_5114,1,39862,39862,81878,42016,42016,887,0,0,0
81888,application_1508364558011_29860,1,66213,66213,81888,15675,15675,324,0,0,0
81909,application_1508364558011_39808,1,73772,73772,81909,8137,8137,180,0,0,0
81926,application_1508364558011_47003,1,80076,80076,81926,1850,1850,65,0,0,0
81926,application_1508364558011_37711,1,72326,72326,81926,9600,9600,206,0,0,0
81926,application_1508364558011_37595,1,72316,72316,81926,9610,9610,183,0,0,0
81926,application_1508364558011_40064,1,73796,73796,81926,8130,8130,199,0,0,0
81974,application_1508364558011_40553,1,73925,73925,81974,8049,8049,191,0,0,0
81984,application_1508364558011_37425,1,72303,72303,81984,9681,9681,185,0,0,0
81994,application_1506638472019_10651,1,18628,18628,81994,63366,63366,2277,0,0,0
82014,application_1508364558011_45807,1,78746,78746,82014,3268,3268,61,0,0,0
82014,application_1508364558011_4809,1,39807,39807,82014,42207,42207,919,0,0,0
82014,application_1508364558011_8638,1,41645,41645,82014,40369,40369,1099,0,0,0
82014,application_1506638472019_7406,1,17213,17213,82014,64801,64801,2447,0,0,0
82016,application_1506638472019_8651,1,17432,17432,82016,64584,64584,2544,0,0,0
82016,application_1508364558011_46459,1,79376,79376,82016,2640,2640,71,0,0,0
82036,application_1506638472019_6393,1,17062,17062,82036,64974,64974,2466,0,0,0
82056,application_1506638472019_7151,1,17162,17162,82056,64894,64894,2471,0,0,0
82076,application_1508364558011_44775,1,78192,78192,82076,3884,3884,80,0,0,0
82106,application_1508364558011_47347,1,80531,80531,82106,1575,1575,54,0,0,0
82106,application_1508364558011_43371,1,77647,77647,82106,4459,4459,79,0,0,0
82116,application_1508364558011_7317,1,41280,41280,82116,40836,40836,960,0,0,0
82116,application_1506638472019_7522,1,17226,17226,82116,64890,64890,2457,0,0,0
82126,application_1506638472019_21490,1,26297,26297,82126,55829,55829,1506,0,0,0
82136,application_1506638472019_6297,1,17042,17042,82136,65094,65094,2217,0,0,0
82166,application_1508364558011_43385,1,77676,77676,82166,4490,4490,72,0,0,0
82176,application_1508364558011_11313,1,43060,43060,82176,39116,39116,868,0,0,0
82196,application_1508364558011_9839,1,42138,42138,82196,40058,40058,854,0,0,0
82226,application_1508364558011_39966,1,73788,73788,82226,8438,8438,255,0,0,0
82246,application_1508364558011_47182,1,80296,80296,82246,1950,1950,65,0,0,0
82256,application_1508364558011_27869,1,62003,62003,82256,20253,20253,347,0,0,0
82256,application_1508364558011_5322,1,39869,39869,82256,42387,42387,945,0,0,0
82276,application_1508364558011_45770,1,78656,78656,82276,3620,3620,66,0,0,0
82276,application_1506638472019_8850,1,17546,17546,82276,64730,64730,2503,0,0,0
82316,application_1508364558011_43491,1,77833,77833,82316,4483,4483,73,0,0,0
82326,application_1508364558011_41721,1,75333,75333,82326,6993,6993,202,0,0,0
82326,application_1508364558011_47512,1,80656,80656,82326,1670,1670,67,0,0,0
82336,application_1508364558011_2303,1,39004,39004,82336,43332,43332,1106,0,0,0
82356,application_1508364558011_37644,1,72320,72320,82356,10036,10036,270,0,0,0
82366,application_1508364558011_37454,1,72305,72305,82366,10061,10061,258,0,0,0
82386,application_1508364558011_8568,1,41644,41644,82386,40742,40742,941,0,0,0
82396,application_1508364558011_47418,1,80556,80556,82396,1840,1840,35,0,0,0
82396,application_1508364558011_46793,1,79726,79726,82396,2670,2670,72,0,0,0
82396,application_1508364558011_36052,1,70335,70335,82396,12061,12061,214,0,0,0
82406,application_1506638472019_22232,1,26531,26531,82406,55875,55875,1638,0,0,0
82416,application_1508364558011_7765,1,41524,41524,82416,40892,40892,1145,0,0,0
82436,application_1508364558011_44816,1,78200,78200,82436,4236,4236,107,0,0,0
82446,application_1508364558011_41030,1,74657,74657,82446,7789,7789,161,0,0,0
82456,application_1506638472019_5009,1,15812,15812,82456,66644,66644,2923,0,0,0
82456,application_1508364558011_47461,1,80591,80591,82456,1865,1865,54,0,0,0
82486,application_1508364558011_31045,1,67319,67319,82486,15167,15167,301,0,0,0
82496,application_1508364558011_46951,1,79952,79952,82496,2544,2544,19,0,0,0
82506,application_1508364558011_4200,1,39362,39362,82506,43144,43144,1062,0,0,0
82506,application_1508364558011_29828,1,66208,66208,82506,16298,16298,354,0,0,0
82516,application_1508364558011_31223,1,67331,67331,82516,15185,15185,198,0,0,0
82526,application_1508364558011_5720,1,40039,40039,82526,42487,42487,1137,0,0,0
82526,application_1508364558011_11649,1,43303,43303,82526,39223,39223,1147,0,0,0
82566,application_1508364558011_39921,1,73782,73782,82566,8784,8784,176,0,0,0
82566,application_1508364558011_42237,1,76115,76115,82566,6451,6451,135,0,0,0
82572,application_1508364558011_33203,1,69266,69266,82572,13306,13306,255,0,0,0
82572,application_1508364558011_31019,1,67317,67317,82572,15255,15255,337,0,0,0
82572,application_1508364558011_15932,4,46279,46279,82572,36293,36293,136,0,0,0
82593,application_1508364558011_44810,1,78199,78199,82593,4394,4394,96,0,0,0
82603,application_1506638472019_21373,1,26283,26283,82603,56320,56320,1557,0,0,0
82613,application_1508364558011_11307,1,43060,43060,82613,39553,39553,961,0,0,0
82643,application_1508364558011_43273,1,77546,77546,82643,5097,5097,72,0,0,0
82643,application_1508364558011_33827,1,69692,69692,82643,12951,12951,223,0,0,0
82643,application_1508364558011_9864,1,42139,42139,82643,40504,40504,885,0,0,0
82722,application_1508364558011_4858,1,39809,39809,82722,42913,42913,990,0,0,0
82722,application_1508364558011_8656,1,41645,41645,82722,41077,41077,1175,0,0,0
82732,application_1508364558011_18444,1,47950,47950,82732,34782,34782,718,0,0,0
82732,application_1506638472019_6657,1,17092,17092,82732,65640,65640,2560,0,0,0
82746,application_1506638472019_21665,1,26314,26314,82746,56432,56432,1537,0,0,0
82756,application_1508364558011_17675,1,47672,47672,82756,35084,35084,734,0,0,0
82766,application_1508364558011_37381,1,72299,72299,82766,10467,10467,177,0,0,0
82786,application_1508364558011_11304,1,43060,43060,82786,39726,39726,905,0,0,0
82806,application_1508364558011_3730,1,39260,39260,82806,43546,43546,1022,0,0,0
82806,application_1508364558011_45310,1,78259,78259,82806,4547,4547,132,0,0,0
82816,application_1508364558011_44898,1,78225,78225,82816,4591,4591,118,0,0,0
82816,application_1508364558011_47578,1,80816,80816,82816,2000,2000,71,0,0,0
82836,application_1508364558011_33900,1,69699,69699,82836,13137,13137,261,0,0,0
82836,application_1508364558011_47481,1,80607,80607,82836,2229,2229,74,0,0,0
82866,application_1506638472019_19466,1,24903,24903,82866,57963,57963,1845,0,0,0
82896,application_1508364558011_43425,1,77726,77726,82896,5170,5170,79,0,0,0
82906,application_1506638472019_21374,1,26284,26284,82906,56622,56622,1604,0,0,0
82906,application_1508364558011_44802,1,78198,78198,82906,4708,4708,102,0,0,0
82906,application_1506638472019_21394,1,26286,26286,82906,56620,56620,1537,0,0,0
82906,application_1508364558011_27286,1,60196,60196,82906,22710,22710,659,0,0,0
82916,application_1508364558011_43838,1,77920,77920,82916,4996,4996,169,0,0,0
82926,application_1506638472019_21807,1,26330,26330,82926,56596,56596,1486,0,0,0
82936,application_1508364558011_47307,1,80508,80508,82936,2428,2428,72,0,0,0
82956,application_1508364558011_12189,1,43506,43506,82956,39450,39450,1062,0,0,0
82956,application_1508364558011_12437,1,43575,43575,82956,39381,39381,880,0,0,0
82959,application_1508364558011_47323,1,80519,80519,82959,2440,2440,56,0,0,0
82969,application_1508364558011_39819,1,73773,73773,82969,9196,9196,308,0,0,0
82969,application_1508364558011_44939,1,78227,78227,82969,4742,4742,95,0,0,0
82979,application_1508364558011_34120,1,69751,69751,82979,13228,13228,182,0,0,0
82986,application_1508364558011_45639,1,78366,78366,82986,4620,4620,69,0,0,0
82996,application_1508364558011_0369,1,37556,37556,82996,45440,45440,1013,0,0,0
83016,application_1508364558011_44940,1,78227,78227,83016,4789,4789,130,0,0,0
83026,application_1508364558011_45843,1,78796,78796,83026,4230,4230,64,0,0,0
83056,application_1508364558011_5641,1,40038,40038,83056,43018,43018,971,0,0,0
83076,application_1508364558011_46868,1,79855,79855,83076,3221,3221,64,0,0,0
83076,application_1506638472019_37052,1,35535,35535,83076,47541,47541,1398,0,0,0
83086,application_1508364558011_44787,1,78195,78195,83086,4891,4891,96,0,0,0
83086,application_1508364558011_18417,1,47948,47948,83086,35138,35138,762,0,0,0
83086,application_1508364558011_39052,1,73616,73616,83086,9470,9470,210,0,0,0
83106,application_1508364558011_11771,1,43441,43441,83106,39665,39665,864,0,0,0
83126,application_1508364558011_45781,1,78696,78696,83126,4430,4430,66,0,0,0
83126,application_1508364558011_38987,1,73610,73610,83126,9516,9516,268,0,0,0
83126,application_1506638472019_19337,1,24872,24872,83126,58254,58254,1827,0,0,0
83136,application_1508364558011_44800,1,78198,78198,83136,4938,4938,99,0,0,0
83146,application_1508364558011_44997,1,78231,78231,83146,4915,4915,136,0,0,0
83166,application_1508364558011_40187,1,73806,73806,83166,9360,9360,254,0,0,0
83166,application_1508364558011_3455,1,39233,39233,83166,43933,43933,1073,0,0,0
83196,application_1508364558011_4884,1,39810,39810,83196,43386,43386,1087,0,0,0
83236,application_1508364558011_43374,1,77653,77653,83236,5583,5583,112,0,0,0
83276,application_1508364558011_9247,1,42015,42015,83276,41261,41261,1104,0,0,0
83286,application_1508364558011_7315,1,41280,41280,83286,42006,42006,1077,0,0,0
83296,application_1508364558011_45720,1,78564,78564,83296,4732,4732,65,0,0,0
83296,application_1508364558011_8196,1,41625,41625,83296,41671,41671,773,0,0,0
83316,application_1508364558011_46510,1,79466,79466,83316,3850,3850,66,0,0,0
83326,application_1508364558011_46937,1,79936,79936,83326,3390,3390,75,0,0,0
83336,application_1508364558011_9633,1,42067,42067,83336,41269,41269,954,0,0,0
83336,application_1508364558011_22978,1,55116,55116,83336,28220,28220,580,0,0,0
83346,application_1506638472019_30915,1,31037,31037,83346,52309,52309,2083,0,0,0
83346,application_1508364558011_11237,1,43015,43015,83346,40331,40331,856,0,0,0
83376,application_1508364558011_39979,1,73789,73789,83376,9587,9587,181,0,0,0
83396,application_1508364558011_45728,1,78575,78575,83396,4821,4821,65,0,0,0
83396,application_1508364558011_37125,4,72129,72129,83396,11267,11267,158,0,0,0
83406,application_1508364558011_5855,1,40042,40042,83406,43364,43364,1169,0,0,0
83416,application_1506638472019_19150,1,24837,24837,83416,58579,58579,1844,0,0,0
83416,application_1508364558011_4715,1,39804,39804,83416,43612,43612,1001,0,0,0
83426,application_1508364558011_33887,1,69698,69698,83426,13728,13728,266,0,0,0
83436,application_1508364558011_18408,1,47948,47948,83436,35488,35488,836,0,0,0
83436,application_1508364558011_14110,1,44889,44889,83436,38547,38547,873,0,0,0
83446,application_1506638472019_18298,1,24570,24570,83446,58876,58876,2040,0,0,0
83456,application_1508364558011_2515,1,39019,39019,83456,44437,44437,1159,0,0,0
83456,application_1506638472019_38206,1,36241,36241,83456,47215,47215,1072,0,0,0
83476,application_1508364558011_47934,1,82326,82326,83476,1150,1150,69,0,0,0
83496,application_1508364558011_47227,1,80446,80446,83496,3050,3050,63,0,0,0
83496,application_1508364558011_37332,1,72294,72294,83496,11202,11202,325,0,0,0
83496,application_1508364558011_6654,1,40813,40813,83496,42683,42683,952,0,0,0
83516,application_1508364558011_2296,1,39004,39004,83516,44512,44512,951,0,0,0
83556,application_1506638472019_19693,1,24964,24964,83556,58592,58592,1934,0,0,0
83576,application_1506638472019_19979,1,25060,25060,83576,58516,58516,1870,0,0,0
83576,application_1508364558011_7650,1,41482,41482,83576,42094,42094,770,0,0,0
83576,application_1508364558011_2033,1,38858,38858,83576,44718,44718,961,0,0,0
83596,application_1506638472019_7624,1,17236,17236,83596,66360,66360,2705,0,0,0
83606,application_1508364558011_10550,1,42167,42167,83606,41439,41439,982,0,0,0
83606,application_1508364558011_2549,1,39023,39023,83606,44583,44583,808,0,0,0
83626,application_1508364558011_45389,1,78270,78270,83626,5356,5356,134,0,0,0
83646,application_1508364558011_46515,1,79470,79470,83646,4176,4176,69,0,0,0
83656,application_1508364558011_2340,1,39005,39005,83656,44651,44651,894,0,0,0
83676,application_1506638472019_21877,1,26337,26337,83676,57339,57339,1543,0,0,0
83686,application_1508364558011_40745,1,74371,74371,83686,9315,9315,139,0,0,0
83696,application_1508364558011_47322,1,80518,80518,83696,3178,3178,61,0,0,0
83706,application_1508364558011_41953,1,75569,75569,83706,8137,8137,167,0,0,0
83716,application_1508364558011_47889,1,82016,82016,83716,1700,1700,69,0,0,0
83730,application_1508364558011_39913,1,73782,73782,83730,9948,9948,186,0,0,0
83740,application_1508364558011_37556,1,72313,72313,83740,11427,11427,188,0,0,0
83748,application_1508364558011_44944,1,78228,78228,83748,5520,5520,141,0,0,0
83748,application_1508364558011_33893,1,69699,69699,83748,14049,14049,314,0,0,0
83759,application_1508364558011_39999,1,73790,73790,83759,9969,9969,253,0,0,0
83766,application_1508364558011_29754,1,66195,66195,83766,17571,17571,362,0,0,0
83796,application_1508364558011_47944,1,82396,82396,83796,1400,1400,63,0,0,0
83806,application_1508364558011_47494,1,80616,80616,83806,3190,3190,68,0,0,0
83836,application_1508364558011_10336,1,42149,42149,83836,41687,41687,883,0,0,0
83836,application_1508364558011_3442,1,39232,39232,83836,44604,44604,1007,0,0,0
83836,application_1508364558011_46045,1,79073,79073,83836,4763,4763,59,0,0,0
83856,application_1508364558011_47571,1,80796,80796,83856,3060,3060,67,0,0,0
83896,application_1508364558011_15341,1,45569,45569,83896,38327,38327,938,0,0,0
83906,application_1508364558011_11100,1,42995,42995,83906,40911,40911,1111,0,0,0
83926,application_1508364558011_3927,1,39298,39298,83926,44628,44628,908,0,0,0
83926,application_1508364558011_31074,1,67321,67321,83926,16605,16605,213,0,0,0
83956,application_1508364558011_46979,1,79996,79996,83956,3960,3960,61,0,0,0
83979,application_1508364558011_38979,1,73610,73610,83979,10369,10369,207,0,0,0
83989,application_1508364558011_47766,1,81396,81396,83989,2593,2593,69,0,0,0
83989,application_1506638472019_12273,1,18852,18852,83989,65137,65137,2076,0,0,0
84006,application_1508364558011_46612,1,79576,79576,84006,4430,4430,64,0,0,0
84016,application_1508364558011_44953,1,78228,78228,84016,5788,5788,142,0,0,0
84016,application_1508364558011_47912,1,82176,82176,84016,1840,1840,68,0,0,0
84036,application_1506638472019_19257,1,24856,24856,84036,59180,59180,1848,0,0,0
84036,application_1508364558011_47743,1,81256,81256,84036,2780,2780,60,0,0,0
84045,application_1508364558011_41925,1,75565,75565,84045,8480,8480,176,0,0,0
84055,application_1508364558011_21511,1,50729,50729,84055,33326,33326,626,0,0,0
84055,application_1506638472019_10754,1,18639,18639,84055,65416,65416,2477,0,0,0
84065,application_1506638472019_34519,1,34596,34596,84065,49469,49469,1192,0,0,0
84095,application_1508364558011_34249,1,69762,69762,84095,14333,14333,302,0,0,0
84105,application_1508364558011_10297,1,42148,42148,84105,41957,41957,942,0,0,0
84115,application_1508364558011_45686,1,78496,78496,84115,5619,5619,62,0,0,0
84115,application_1506638472019_6864,1,17143,17143,84115,66972,66972,2555,0,0,0
84135,application_1508364558011_39003,1,73612,73612,84135,10523,10523,262,0,0,0
84145,application_1506638472019_28457,1,29163,29163,84145,54982,54982,2249,0,0,0
84145,application_1506638472019_19240,1,24853,24853,84145,59292,59292,1836,0,0,0
84145,application_1508364558011_23256,1,55850,55850,84145,28295,28295,738,0,0,0
84155,application_1508364558011_38942,1,73607,73607,84155,10548,10548,212,0,0,0
84155,application_1508364558011_44812,1,78199,78199,84155,5956,5956,107,0,0,0
84165,application_1508364558011_8870,1,41849,41849,84165,42316,42316,1435,0,0,0
84185,application_1508364558011_37372,1,72298,72298,84185,11887,11887,315,0,0,0
84195,application_1508364558011_4696,1,39804,39804,84195,44391,44391,1039,0,0,0
84215,application_1508364558011_3262,1,39217,39217,84215,44998,44998,1278,0,0,0
84235,application_1508364558011_31037,1,67318,67318,84235,16917,16917,322,0,0,0
84245,application_1508364558011_12450,1,43576,43576,84245,40669,40669,884,0,0,0
84245,application_1508364558011_29750,1,66194,66194,84245,18051,18051,369,0,0,0
84265,application_1508364558011_11129,1,42996,42996,84265,41269,41269,932,0,0,0
84265,application_1508364558011_44803,1,78199,78199,84265,6066,6066,101,0,0,0
84265,application_1508364558011_11250,1,43016,43016,84265,41249,41249,1205,0,0,0
84265,application_1508364558011_14094,1,44888,44888,84265,39377,39377,1009,0,0,0
84295,application_1508364558011_41948,1,75568,75568,84295,8727,8727,183,0,0,0
84295,application_1508364558011_10317,1,42148,42148,84295,42147,42147,1047,0,0,0
84305,application_1508364558011_15265,1,45568,45568,84305,38737,38737,782,0,0,0
84316,application_1506638472019_19865,1,24997,24997,84316,59319,59319,1823,0,0,0
84326,application_1508364558011_47989,1,82746,82746,84326,1580,1580,65,0,0,0
84326,application_1508364558011_47853,1,81848,81848,84326,2478,2478,69,0,0,0
84326,application_1508364558011_46059,1,79076,79076,84326,5250,5250,62,0,0,0
84336,application_1506638472019_22320,1,26540,26540,84336,57796,57796,1556,0,0,0
84336,application_1508364558011_47746,1,81276,81276,84336,3060,3060,63,0,0,0
84395,application_1508364558011_44883,1,78224,78224,84395,6171,6171,134,0,0,0
84415,application_1506638472019_7129,1,17160,17160,84415,67255,67255,2496,0,0,0
84425,application_1508364558011_7322,1,41280,41280,84425,43145,43145,875,0,0,0
84466,application_1508364558011_9948,1,42140,42140,84466,42326,42326,935,0,0,0
84466,application_1508364558011_38782,1,73594,73594,84466,10872,10872,185,0,0,0
84496,application_1506638472019_18117,1,24535,24535,84496,59961,59961,2132,0,0,0
84496,application_1508364558011_44761,1,78188,78188,84496,6308,6308,98,0,0,0
84526,application_1506638472019_7985,1,17277,17277,84526,67249,67249,2626,0,0,0
84526,application_1508364558011_47078,1,80186,80186,84526,4340,4340,61,0,0,0
84526,application_1508364558011_47471,1,80601,80601,84526,3925,3925,109,0,0,0
84526,application_1508364558011_41927,1,75565,75565,84526,8961,8961,171,0,0,0
84539,application_1508364558011_38908,1,73604,73604,84539,10935,10935,207,0,0,0
84539,application_1506638472019_19397,1,24885,24885,84539,59654,59654,1912,0,0,0
84559,application_1508364558011_45039,1,78235,78235,84559,6324,6324,183,0,0,0
84566,application_1508364558011_34238,1,69762,69762,84566,14804,14804,269,0,0,0
84569,application_1506638472019_19374,1,24880,24880,84569,59689,59689,1858,0,0,0
84588,application_1508364558011_47686,1,81052,81052,84588,3536,3536,71,0,0,0
84604,application_1508364558011_38996,1,73611,73611,84604,10993,10993,261,0,0,0
84612,application_1508364558011_9452,1,42065,42065,84612,42547,42547,890,0,0,0
84639,application_1508364558011_44015,1,77972,77972,84639,6667,6667,78,0,0,0
84639,application_1508364558011_9130,1,41853,41853,84639,42786,42786,1069,0,0,0
84649,application_1506638472019_38170,1,36239,36239,84649,48410,48410,1115,0,0,0
84649,application_1508364558011_41949,1,75568,75568,84649,9081,9081,196,0,0,0
84667,application_1508364558011_3485,1,39237,39237,84667,45430,45430,1154,0,0,0
84667,application_1508364558011_37442,1,72304,72304,84667,12363,12363,260,0,0,0
84685,application_1508364558011_39706,1,73764,73764,84685,10921,10921,220,0,0,0
84712,application_1506638472019_7268,1,17169,17169,84712,67543,67543,2629,0,0,0
84736,application_1508364558011_5777,1,40041,40041,84736,44695,44695,1138,0,0,0
84756,application_1508364558011_40062,1,73796,73796,84756,10960,10960,253,0,0,0
84756,application_1508364558011_31737,1,68136,68136,84756,16620,16620,327,0,0,0
84765,application_1508364558011_47901,1,82106,82106,84765,2659,2659,53,0,0,0
84775,application_1508364558011_18746,4,48024,48024,84775,36751,36751,194,0,0,0
84795,application_1508364558011_45168,1,78247,78247,84795,6548,6548,113,0,0,0
84815,application_1508364558011_44792,1,78197,78197,84815,6618,6618,104,0,0,0
84815,application_1508364558011_39795,1,73771,73771,84815,11044,11044,178,0,0,0
84825,application_1506638472019_19778,1,24980,24980,84825,59845,59845,1859,0,0,0
84825,application_1506638472019_19739,1,24973,24973,84825,59852,59852,1807,0,0,0
84835,application_1506638472019_11573,1,18738,18738,84835,66097,66097,2226,0,0,0
84848,application_1506638472019_19954,1,25053,25053,84848,59795,59795,1799,0,0,0
84856,application_1506638472019_6538,1,17077,17077,84856,67779,67779,2563,0,0,0
84944,application_1508364558011_47757,1,81326,81326,84944,3618,3618,67,0,0,0
84954,application_1508364558011_8209,1,41625,41625,84954,43329,43329,916,0,0,0
84997,application_1508364558011_45076,1,78238,78238,84997,6759,6759,166,0,0,0
85007,application_1508364558011_45073,1,78238,78238,85007,6769,6769,169,0,0,0
85007,application_1506638472019_17386,1,23763,23763,85007,61244,61244,1641,0,0,0
85017,application_1508364558011_37386,1,72299,72299,85017,12718,12718,254,0,0,0
85017,application_1508364558011_37554,1,72313,72313,85017,12704,12704,178,0,0,0
85027,application_1508364558011_48068,1,83316,83316,85027,1711,1711,66,0,0,0
85027,application_1508364558011_46527,1,79482,79482,85027,5545,5545,75,0,0,0
85049,application_1508364558011_48063,1,83286,83286,85049,1763,1763,60,0,0,0
85082,application_1508364558011_47751,1,81316,81316,85082,3766,3766,66,0,0,0
85088,application_1508364558011_34435,1,69778,69778,85088,15310,15310,267,0,0,0
85108,application_1508364558011_10238,1,42147,42147,85108,42961,42961,910,0,0,0
85115,application_1508364558011_2214,1,39001,39001,85115,46114,46114,1002,0,0,0
85115,application_1508364558011_3427,1,39230,39230,85115,45885,45885,988,0,0,0
85136,application_1508364558011_48200,1,83896,83896,85136,1240,1240,67,0,0,0
85146,application_1508364558011_41928,1,75565,75565,85146,9581,9581,188,0,0,0
85146,application_1508364558011_14098,1,44888,44888,85146,40258,40258,962,0,0,0
85156,application_1508364558011_48075,1,83376,83376,85156,1780,1780,67,0,0,0
85195,application_1508364558011_46138,1,79115,79115,85195,6080,6080,101,0,0,0
85205,application_1508364558011_44856,1,78221,78221,85205,6984,6984,196,0,0,0
85205,application_1508364558011_7304,1,41280,41280,85205,43925,43925,1071,0,0,0
85213,application_1508364558011_1703,1,38784,38784,85213,46429,46429,1292,0,0,0
85213,application_1506638472019_6562,1,17080,17080,85213,68133,68133,2495,0,0,0
85257,application_1508364558011_2421,1,39011,39011,85257,46246,46246,1328,0,0,0
85267,application_1508364558011_8750,1,41647,41647,85267,43620,43620,1119,0,0,0
85267,application_1506638472019_3585,1,13530,13530,85267,71737,71737,3494,0,0,0
85277,application_1508364558011_36634,1,71007,71007,85277,14270,14270,384,0,0,0
85277,application_1508364558011_29028,4,65290,65290,85277,19987,19987,108,0,0,0
85287,application_1506638472019_19952,1,25053,25053,85287,60234,60234,1828,0,0,0
85292,application_1508364558011_7443,1,41282,41282,85292,44010,44010,1128,0,0,0
85332,application_1508364558011_27323,1,60203,60203,85332,25129,25129,635,0,0,0
85382,application_1508364558011_39672,1,73761,73761,85382,11621,11621,402,0,0,0
85404,application_1508364558011_24807,1,57373,57373,85404,28031,28031,986,0,0,0
85414,application_1506638472019_6431,1,17065,17065,85414,68349,68349,2515,0,0,0
85414,application_1506638472019_18305,1,24571,24571,85414,60843,60843,2124,0,0,0
85418,application_1506638472019_6410,1,17063,17063,85418,68355,68355,2640,0,0,0
85418,application_1508364558011_37122,4,72117,72117,85418,13301,13301,139,0,0,0
85446,application_1506638472019_18729,1,24626,24626,85446,60820,60820,2024,0,0,0
85456,application_1508364558011_6484,1,40811,40811,85456,44645,44645,1314,0,0,0
85466,application_1508364558011_15201,1,45567,45567,85466,39899,39899,1167,0,0,0
85466,application_1508364558011_10144,1,42145,42145,85466,43321,43321,1290,0,0,0
85486,application_1506638472019_8131,1,17291,17291,85486,68195,68195,2695,0,0,0
85504,application_1506638472019_8066,1,17286,17286,85504,68218,68218,2557,0,0,0
85504,application_1506638472019_6602,1,17087,17087,85504,68417,68417,2442,0,0,0
85542,application_1508364558011_44133,1,78096,78096,85542,7446,7446,468,0,0,0
85592,application_1508364558011_40077,1,73798,73798,85592,11794,11794,310,0,0,0
85602,application_1508364558011_12425,1,43575,43575,85602,42027,42027,1280,0,0,0
85602,application_1506638472019_17743,1,24473,24473,85602,61129,61129,2056,0,0,0
85616,application_1508364558011_18994,1,48249,48249,85616,37367,37367,1404,0,0,0
85636,application_1508364558011_31692,1,68028,68028,85636,17608,17608,702,0,0,0
85666,application_1506638472019_35125,1,34836,34836,85666,50830,50830,1611,0,0,0
85676,application_1508364558011_16579,1,46656,46656,85676,39020,39020,1350,0,0,0
85686,application_1506638472019_8018,1,17281,17281,85686,68405,68405,2716,0,0,0
85706,application_1506638472019_30063,1,30921,30921,85706,54785,54785,1947,0,0,0
85726,application_1508364558011_17604,1,47664,47664,85726,38062,38062,1321,0,0,0
85726,application_1508364558011_27240,1,60188,60188,85726,25538,25538,1070,0,0,0
85736,application_1508364558011_13476,1,44655,44655,85736,41081,41081,1453,0,0,0
85746,application_1506638472019_18651,1,24619,24619,85746,61127,61127,2231,0,0,0
85756,application_1508364558011_19664,1,49112,49112,85756,36644,36644,1385,0,0,0
85756,application_1508364558011_36949,1,71797,71797,85756,13959,13959,859,0,0,0
85756,application_1506638472019_8064,1,17286,17286,85756,68470,68470,2698,0,0,0
85776,application_1506638472019_5787,1,15907,15907,85776,69869,69869,3108,0,0,0
85806,application_1508364558011_44941,1,78227,78227,85806,7579,7579,340,0,0,0
85806,application_1508364558011_39588,1,73754,73754,85806,12052,12052,898,0,0,0
85806,application_1508364558011_18639,1,48008,48008,85806,37798,37798,687,0,0,0
85826,application_1506638472019_30329,1,30951,30951,85826,54875,54875,2074,0,0,0
85836,application_1506638472019_18480,1,24599,24599,85836,61237,61237,2056,0,0,0
85836,application_1506638472019_30479,1,30967,30967,85836,54869,54869,2032,0,0,0
85850,application_1508364558011_14864,4,45382,45382,85850,40468,40468,132,0,0,0
85870,application_1506638472019_21673,1,26315,26315,85870,59555,59555,1469,0,0,0
85870,application_1506638472019_18974,1,24802,24802,85870,61068,61068,1834,0,0,0
85870,application_1508364558011_12432,1,43575,43575,85870,42295,42295,898,0,0,0
85880,application_1508364558011_47980,1,82662,82662,85880,3218,3218,80,0,0,0
85880,application_1508364558011_3859,1,39292,39292,85880,46588,46588,943,0,0,0
85880,application_1508364558011_37909,2,72793,72793,85880,13087,13087,15,0,0,0
85896,application_1508364558011_28344,1,63818,63818,85896,22078,22078,438,0,0,0
85896,application_1508364558011_38065,2,73381,73381,85896,12515,12515,16,0,0,0
85916,application_1506638472019_7710,1,17248,17248,85916,68668,68668,2697,0,0,0
85916,application_1506638472019_18607,1,24614,24614,85916,61302,61302,2022,0,0,0
85916,application_1506638472019_18707,1,24624,24624,85916,61292,61292,2070,0,0,0
85916,application_1508364558011_39488,2,73679,73679,85916,12237,12237,17,0,0,0
85926,application_1506638472019_19894,1,25003,25003,85926,60923,60923,1872,0,0,0
85936,application_1508364558011_38958,1,73608,73608,85936,12328,12328,321,0,0,0
85936,application_1508364558011_47333,1,80526,80526,85936,5410,5410,218,0,0,0
85946,application_1508364558011_9554,1,42066,42066,85946,43880,43880,807,0,0,0
85946,application_1508364558011_27079,1,59959,59959,85946,25987,25987,724,0,0,0
85956,application_1508364558011_2504,1,39018,39018,85956,46938,46938,1159,0,0,0
85956,application_1508364558011_11165,1,42998,42998,85956,42958,42958,1019,0,0,0
85966,application_1508364558011_48860,1,84905,84905,85966,1061,1061,97,0,0,0
85966,application_1508364558011_39810,1,73772,73772,85966,12194,12194,375,0,0,0
85976,application_1506638472019_31183,1,31202,31202,85976,54774,54774,2098,0,0,0
86012,application_1506638472019_19418,1,24889,24889,86012,61123,61123,1866,0,0,0
86032,application_1508364558011_10542,1,42166,42166,86032,43866,43866,1028,0,0,0
86042,application_1506638472019_19282,1,24861,24861,86042,61181,61181,1783,0,0,0
86052,application_1508364558011_39763,1,73769,73769,86052,12283,12283,373,0,0,0
86064,application_1508364558011_36134,1,70413,70413,86064,15651,15651,465,0,0,0
86064,application_1506638472019_7746,1,17255,17255,86064,68809,68809,2670,0,0,0
86084,application_1506638472019_19027,1,24814,24814,86084,61270,61270,1922,0,0,0
86094,application_1506638472019_7872,1,17267,17267,86094,68827,68827,2665,0,0,0
86094,application_1508364558011_6636,1,40813,40813,86094,45281,45281,1144,0,0,0
86124,application_1508364558011_44138,1,78097,78097,86124,8027,8027,451,0,0,0
86124,application_1506638472019_3602,1,13531,13531,86124,72593,72593,3648,0,0,0
86124,application_1508364558011_9957,1,42140,42140,86124,43984,43984,1363,0,0,0
86144,application_1508364558011_11292,1,43060,43060,86144,43084,43084,1278,0,0,0
86154,application_1506638472019_7589,1,17233,17233,86154,68921,68921,2644,0,0,0
86174,application_1508364558011_44309,1,78142,78142,86174,8032,8032,480,0,0,0
86184,application_1506638472019_19840,1,24992,24992,86184,61192,61192,1848,0,0,0
86200,application_1506638472019_7756,1,17256,17256,86200,68944,68944,2782,0,0,0
86220,application_1508364558011_29692,1,66182,66182,86220,20038,20038,662,0,0,0
86230,application_1508364558011_9147,1,41853,41853,86230,44377,44377,868,0,0,0
86240,application_1508364558011_39853,1,73776,73776,86240,12464,12464,300,0,0,0
86240,application_1506638472019_19267,1,24859,24859,86240,61381,61381,1914,0,0,0
86240,application_1508364558011_40558,2,73933,73933,86240,12307,12307,20,0,0,0
86258,application_1506638472019_19913,1,25007,25007,86258,61251,61251,1881,0,0,0
86258,application_1508364558011_41041,2,74680,74680,86258,11578,11578,18,0,0,0
86268,application_1508364558011_30921,1,67287,67287,86268,18981,18981,404,0,0,0
86296,application_1506638472019_7782,1,17259,17259,86296,69037,69037,2592,0,0,0
86306,application_1508364558011_33785,1,69688,69688,86306,16618,16618,323,0,0,0
86316,application_1506638472019_10774,1,18641,18641,86316,67675,67675,2250,0,0,0
86336,application_1506638472019_19311,1,24867,24867,86336,61469,61469,1892,0,0,0
86341,application_1508364558011_29898,1,66218,66218,86341,20123,20123,484,0,0,0
86366,application_1506638472019_6625,1,17089,17089,86366,69277,69277,2640,0,0,0
86379,application_1508364558011_23205,1,55846,55846,86379,30533,30533,735,0,0,0
86407,application_1508364558011_48862,1,84905,84905,86407,1502,1502,187,0,0,0
86437,application_1508364558011_44412,1,78154,78154,86437,8283,8283,329,0,0,0
86457,application_1508364558011_39575,1,73753,73753,86457,12704,12704,515,0,0,0
86477,application_1508364558011_9041,1,41851,41851,86477,44626,44626,1175,0,0,0
86487,application_1508364558011_5102,1,39861,39861,86487,46626,46626,1279,0,0,0
86537,application_1508364558011_48279,4,84045,84045,86537,2492,2492,56,0,0,0
86547,application_1508364558011_37550,1,72313,72313,86547,14234,14234,580,0,0,0
86547,application_1508364558011_11327,1,43061,43061,86547,43486,43486,1111,0,0,0
86556,application_1506638472019_4963,1,15810,15810,86556,70746,70746,3079,0,0,0
86573,application_1508364558011_7074,1,41192,41192,86573,45381,45381,1859,0,0,0
86588,application_1506638472019_30728,1,31018,31018,86588,55570,55570,1947,0,0,0
86598,application_1508364558011_11530,1,43297,43297,86598,43301,43301,1167,0,0,0
86620,application_1508364558011_27756,1,61579,61579,86620,25041,25041,803,0,0,0
86630,application_1508364558011_43605,1,77898,77898,86630,8732,8732,575,0,0,0
86630,application_1506638472019_18470,1,24598,24598,86630,62032,62032,2096,0,0,0
86666,application_1508364558011_4310,1,39364,39364,86666,47302,47302,1496,0,0,0
86676,application_1508364558011_39814,1,73773,73773,86676,12903,12903,384,0,0,0
86686,application_1508364558011_34983,1,69873,69873,86686,16813,16813,772,0,0,0
86696,application_1506638472019_9021,1,17571,17571,86696,69125,69125,2715,0,0,0
86696,application_1508364558011_18806,1,48068,48068,86696,38628,38628,1141,0,0,0
86696,application_1506638472019_7402,1,17213,17213,86696,69483,69483,2564,0,0,0
86716,application_1506638472019_9041,1,17574,17574,86716,69142,69142,2738,0,0,0
86736,application_1506638472019_18302,1,24570,24570,86736,62166,62166,2134,0,0,0
86736,application_1508364558011_44839,1,78213,78213,86736,8523,8523,633,0,0,0
86746,application_1508364558011_16667,1,46689,46689,86746,40057,40057,1568,0,0,0
86746,application_1508364558011_9821,1,42138,42138,86746,44608,44608,898,0,0,0
86756,application_1506638472019_3537,1,13438,13438,86756,73318,73318,3613,0,0,0
86756,application_1506638472019_19699,1,24965,24965,86756,61791,61791,2063,0,0,0
86756,application_1508364558011_41956,1,75570,75570,86756,11186,11186,230,0,0,0
86795,application_1506638472019_7429,1,17216,17216,86795,69579,69579,2477,0,0,0
86805,application_1508364558011_5306,1,39869,39869,86805,46936,46936,1247,0,0,0
86815,application_1508364558011_47033,1,80116,80116,86815,6699,6699,65,0,0,0
86815,application_1506638472019_22031,1,26366,26366,86815,60449,60449,1531,0,0,0
86815,application_1508364558011_31302,1,67435,67435,86815,19380,19380,371,0,0,0
86825,application_1508364558011_26110,1,58483,58483,86825,28342,28342,622,0,0,0
86835,application_1508364558011_43685,1,77905,77905,86835,8930,8930,177,0,0,0
86845,application_1508364558011_47426,1,80558,80558,86845,6287,6287,114,0,0,0
86846,application_1508364558011_47510,1,80656,80656,86846,6190,6190,75,0,0,0
86856,application_1508364558011_47958,1,82496,82496,86856,4360,4360,59,0,0,0
86876,application_1508364558011_37235,1,72287,72287,86876,14589,14589,298,0,0,0
86886,application_1508364558011_43562,1,77894,77894,86886,8992,8992,188,0,0,0
86917,application_1506638472019_30772,1,31023,31023,86917,55894,55894,2001,0,0,0
86929,application_1506638472019_19873,1,25000,25000,86929,61929,61929,1845,0,0,0
86929,application_1508364558011_13933,1,44831,44831,86929,42098,42098,884,0,0,0
86939,application_1506638472019_7611,1,17235,17235,86939,69704,69704,2525,0,0,0
86939,application_1508364558011_39836,1,73775,73775,86939,13164,13164,190,0,0,0
86944,application_1506638472019_39055,1,37057,37057,86944,49887,49887,982,0,0,0
86944,application_1508364558011_38977,1,73610,73610,86944,13334,13334,255,0,0,0
86964,application_1508364558011_37667,1,72322,72322,86964,14642,14642,249,0,0,0
86973,application_1508364558011_39027,1,73614,73614,86973,13359,13359,233,0,0,0
86983,application_1508364558011_14421,1,45026,45026,86983,41957,41957,1034,0,0,0
86986,application_1508364558011_48342,4,84235,84235,86986,2751,2751,43,0,0,0
86996,application_1508364558011_43653,1,77902,77902,86996,9094,9094,188,0,0,0
87006,application_1508364558011_10981,1,42906,42906,87006,44100,44100,957,0,0,0
87006,application_1508364558011_44916,1,78226,78226,87006,8780,8780,107,0,0,0
87006,application_1508364558011_37266,1,72289,72289,87006,14717,14717,254,0,0,0
87016,application_1508364558011_9181,1,41854,41854,87016,45162,45162,1206,0,0,0
87026,application_1506638472019_6556,1,17079,17079,87026,69947,69947,2446,0,0,0
87045,application_1508364558011_48267,1,83996,83996,87045,3049,3049,64,0,0,0
87066,application_1506638472019_3121,1,13370,13370,87066,73696,73696,3862,0,0,0
87066,application_1508364558011_41995,1,75646,75646,87066,11420,11420,282,0,0,0
87086,application_1506638472019_21830,1,26332,26332,87086,60754,60754,1458,0,0,0
87096,application_1508364558011_45131,1,78244,78244,87096,8852,8852,170,0,0,0
87126,application_1508364558011_16412,1,46507,46507,87126,40619,40619,1154,0,0,0
87136,application_1508364558011_11175,1,43013,43013,87136,44123,44123,866,0,0,0
87146,application_1508364558011_48371,4,84365,84365,87146,2781,2781,116,0,0,0
87156,application_1508364558011_47767,1,81406,81406,87156,5750,5750,68,0,0,0
87166,application_1506638472019_17991,1,24512,24512,87166,62654,62654,2127,0,0,0
87176,application_1506638472019_39093,1,37058,37058,87176,50118,50118,1187,0,0,0
87186,application_1508364558011_9050,1,41851,41851,87186,45335,45335,961,0,0,0
87204,application_1508364558011_24713,1,57339,57339,87204,29865,29865,787,0,0,0
87222,application_1508364558011_48042,1,83166,83166,87222,4056,4056,68,0,0,0
87230,application_1508364558011_48974,1,85029,85029,87230,2201,2201,16,0,0,0
87248,application_1508364558011_8225,1,41625,41625,87248,45623,45623,1033,0,0,0
87248,application_1508364558011_36412,1,70691,70691,87248,16557,16557,254,0,0,0
87275,application_1506638472019_19275,1,24860,24860,87275,62415,62415,1838,0,0,0
87293,application_1508364558011_4733,1,39805,39805,87293,47488,47488,968,0,0,0
87320,application_1508364558011_39043,1,73615,73615,87320,13705,13705,323,0,0,0
87320,application_1508364558011_41968,2,75605,75605,87320,11715,11715,19,0,0,0
87330,application_1508364558011_48129,1,83656,83656,87330,3674,3674,100,0,0,0
87330,application_1508364558011_42032,2,75754,75754,87330,11576,11576,9,0,0,0
87353,application_1508364558011_49834,1,86356,86356,87353,997,997,53,0,0,0
87353,application_1508364558011_42676,2,76657,76657,87353,10696,10696,18,0,0,0
87373,application_1508364558011_49724,1,86210,86210,87373,1163,1163,66,0,0,0
87408,application_1506638472019_6866,1,17143,17143,87408,70265,70265,2461,0,0,0
87422,application_1508364558011_35194,1,69936,69936,87422,17486,17486,346,0,0,0
87432,application_1508364558011_38974,1,73609,73609,87432,13823,13823,389,0,0,0
87470,application_1508364558011_39697,1,73763,73763,87470,13707,13707,388,0,0,0
87474,application_1508364558011_34062,1,69723,69723,87474,17751,17751,409,0,0,0
87481,application_1508364558011_44494,1,78160,78160,87481,9321,9321,226,0,0,0
87494,application_1508364558011_46644,1,79602,79602,87494,7892,7892,177,0,0,0
87494,application_1506638472019_5597,1,15899,15899,87494,71595,71595,2753,0,0,0
87500,application_1508364558011_3931,1,39298,39298,87500,48202,48202,1023,0,0,0
87511,application_1508364558011_43545,1,77893,77893,87511,9618,9618,218,0,0,0
87531,application_1506638472019_22113,1,26517,26517,87531,61014,61014,1540,0,0,0
87541,application_1508364558011_36006,1,70255,70255,87541,17286,17286,375,0,0,0
87553,application_1508364558011_43758,1,77912,77912,87553,9641,9641,182,0,0,0
87573,application_1508364558011_4609,1,39800,39800,87573,47773,47773,1596,0,0,0
87573,application_1508364558011_10467,1,42164,42164,87573,45409,45409,1171,0,0,0
87583,application_1506638472019_11707,1,18773,18773,87583,68810,68810,2584,0,0,0
87595,application_1506638472019_12033,1,18809,18809,87595,68786,68786,2291,0,0,0
87605,application_1508364558011_1811,1,38839,38839,87605,48766,48766,1199,0,0,0
87615,application_1508364558011_44352,1,78149,78149,87615,9466,9466,243,0,0,0
87626,application_1508364558011_0330,1,37504,37504,87626,50122,50122,1240,0,0,0
87626,application_1508364558011_34287,1,69766,69766,87626,17860,17860,502,0,0,0
87656,application_1508364558011_23208,1,55846,55846,87656,31810,31810,1102,0,0,0
87726,application_1508364558011_47325,1,80521,80521,87726,7205,7205,166,0,0,0
87726,application_1506638472019_20735,1,26030,26030,87726,61696,61696,1662,0,0,0
87758,application_1506638472019_18486,1,24600,24600,87758,63158,63158,2170,0,0,0
87758,application_1508364558011_8250,1,41626,41626,87758,46132,46132,1306,0,0,0
87769,application_1506638472019_19495,1,24909,24909,87769,62860,62860,1902,0,0,0
87769,application_1508364558011_1905,1,38853,38853,87769,48916,48916,1437,0,0,0
87779,application_1508364558011_17673,1,47667,47667,87779,40112,40112,1453,0,0,0
87789,application_1508364558011_44095,1,78092,78092,87789,9697,9697,490,0,0,0
87809,application_1508364558011_37278,1,72290,72290,87809,15519,15519,593,0,0,0
87819,application_1506638472019_16400,1,23137,23137,87819,64682,64682,2665,0,0,0
87819,application_1508364558011_33855,1,69695,69695,87819,18124,18124,529,0,0,0
87846,application_1506638472019_10645,1,18627,18627,87846,69219,69219,2563,0,0,0
87856,application_1508364558011_50178,1,86766,86766,87856,1090,1090,70,0,0,0
87870,application_1508364558011_45520,1,78344,78344,87870,9526,9526,531,0,0,0
87873,application_1506638472019_7902,1,17269,17269,87873,70604,70604,2712,0,0,0
87940,application_1506638472019_18476,1,24599,24599,87940,63341,63341,2073,0,0,0
87950,application_1508364558011_1897,1,38853,38853,87950,49097,49097,1517,0,0,0
87986,application_1508364558011_19427,1,48804,48804,87986,39182,39182,1196,0,0,0
87986,application_1508364558011_43168,2,77340,77340,87986,10646,10646,22,0,0,0
87996,application_1508364558011_48648,1,84606,84606,87996,3390,3390,53,0,0,0
88004,application_1508364558011_26531,1,58985,58985,88004,29019,29019,691,0,0,0
88004,application_1508364558011_1908,1,38853,38853,88004,49151,49151,1320,0,0,0
88014,application_1508364558011_4228,1,39362,39362,88014,48652,48652,1372,0,0,0
88039,application_1506638472019_19390,1,24884,24884,88039,63155,63155,1855,0,0,0
88039,application_1508364558011_14128,1,44890,44890,88039,43149,43149,932,0,0,0
88066,application_1506638472019_7062,1,17156,17156,88066,70910,70910,2516,0,0,0
88072,application_1508364558011_0436,1,37559,37559,88072,50513,50513,1160,0,0,0
88083,application_1508364558011_5803,1,40041,40041,88083,48042,48042,1252,0,0,0
88093,application_1506638472019_7414,1,17214,17214,88093,70879,70879,2439,0,0,0
88103,application_1508364558011_16520,1,46569,46569,88103,41534,41534,1186,0,0,0
88103,application_1508364558011_47505,1,80646,80646,88103,7457,7457,196,0,0,0
88116,application_1508364558011_43680,1,77904,77904,88116,10212,10212,169,0,0,0
88146,application_1506638472019_7677,1,17244,17244,88146,70902,70902,2564,0,0,0
88202,application_1506638472019_8126,1,17291,17291,88202,70911,70911,2753,0,0,0
88202,application_1508364558011_11266,1,43059,43059,88202,45143,45143,1266,0,0,0
88212,application_1508364558011_3206,1,39214,39214,88212,48998,48998,1273,0,0,0
88222,application_1508364558011_49156,1,85217,85217,88222,3005,3005,316,0,0,0
88226,application_1508364558011_37548,1,72313,72313,88226,15913,15913,581,0,0,0
88226,application_1508364558011_37247,1,72288,72288,88226,15938,15938,509,0,0,0
88285,application_1508364558011_4419,1,39366,39366,88285,48919,48919,1375,0,0,0
88320,application_1508364558011_8683,1,41646,41646,88320,46674,46674,1347,0,0,0
88350,application_1508364558011_43358,2,77638,77638,88350,10712,10712,26,0,0,0
88360,application_1508364558011_21410,1,50726,50726,88360,37634,37634,854,0,0,0
88360,application_1508364558011_48738,1,84765,84765,88360,3595,3595,75,0,0,0
88370,application_1506638472019_21700,1,26317,26317,88370,62053,62053,1508,0,0,0
88380,application_1508364558011_38871,1,73602,73602,88380,14778,14778,186,0,0,0
88380,application_1508364558011_43402,2,77697,77697,88380,10683,10683,28,0,0,0
88410,application_1508364558011_49558,1,86054,86054,88410,2356,2356,35,0,0,0
88440,application_1508364558011_49683,1,86184,86184,88440,2256,2256,73,0,0,0
88450,application_1508364558011_34913,1,69866,69866,88450,18584,18584,258,0,0,0
88460,application_1508364558011_45038,1,78235,78235,88460,10225,10225,224,0,0,0
88472,application_1508364558011_48679,1,84654,84654,88472,3818,3818,52,0,0,0
88472,application_1508364558011_33574,1,69525,69525,88472,18947,18947,837,0,0,0
88472,application_1508364558011_44292,2,78141,78141,88472,10331,10331,26,0,0,0
88481,application_1508364558011_48124,1,83636,83636,88481,4845,4845,97,0,0,0
88481,application_1508364558011_38814,1,73597,73597,88481,14884,14884,292,0,0,0
88501,application_1506638472019_22028,1,26365,26365,88501,62136,62136,1515,0,0,0
88511,application_1508364558011_48837,1,84876,84876,88511,3635,3635,75,0,0,0
88521,application_1508364558011_50353,1,86986,86986,88521,1535,1535,76,0,0,0
88531,application_1506638472019_19006,1,24808,24808,88531,63723,63723,1889,0,0,0
88531,application_1506638472019_18858,1,24781,24781,88531,63750,63750,1904,0,0,0
88536,application_1506638472019_6871,1,17144,17144,88536,71392,71392,2474,0,0,0
88536,application_1508364558011_13799,1,44695,44695,88536,43841,43841,1049,0,0,0
88556,application_1506638472019_6584,1,17086,17086,88556,71470,71470,2642,0,0,0
88566,application_1508364558011_29726,1,66191,66191,88566,22375,22375,491,0,0,0
88576,application_1508364558011_40383,1,73901,73901,88576,14675,14675,360,0,0,0
88586,application_1508364558011_45231,1,78253,78253,88586,10333,10333,352,0,0,0
88626,application_1506638472019_10624,1,18624,18624,88626,70002,70002,2608,0,0,0
88646,application_1508364558011_11202,1,43014,43014,88646,45632,45632,1287,0,0,0
88681,application_1508364558011_34964,1,69870,69870,88681,18811,18811,513,0,0,0
88691,application_1508364558011_17689,1,47684,47684,88691,41007,41007,1233,0,0,0
88691,application_1506638472019_10650,1,18627,18627,88691,70064,70064,2575,0,0,0
88701,application_1508364558011_39394,1,73646,73646,88701,15055,15055,514,0,0,0
88701,application_1508364558011_8909,1,41849,41849,88701,46852,46852,1241,0,0,0
88721,application_1508364558011_44969,1,78229,78229,88721,10492,10492,189,0,0,0
88721,application_1506638472019_19914,1,25007,25007,88721,63714,63714,1811,0,0,0
88731,application_1508364558011_43804,1,77916,77916,88731,10815,10815,446,0,0,0
88741,application_1508364558011_10037,1,42141,42141,88741,46600,46600,941,0,0,0
88741,application_1508364558011_2135,1,38994,38994,88741,49747,49747,1547,0,0,0
88741,application_1508364558011_45089,1,78239,78239,88741,10502,10502,168,0,0,0
88776,application_1508364558011_29733,1,66192,66192,88776,22584,22584,363,0,0,0
88796,application_1506638472019_6456,1,17068,17068,88796,71728,71728,2453,0,0,0
88796,application_1506638472019_19929,1,25011,25011,88796,63785,63785,1863,0,0,0
88796,application_1508364558011_39908,1,73781,73781,88796,15015,15015,300,0,0,0
88816,application_1508364558011_10609,1,42169,42169,88816,46647,46647,930,0,0,0
88826,application_1508364558011_38975,1,73609,73609,88826,15217,15217,274,0,0,0
88856,application_1506638472019_6535,1,17077,17077,88856,71779,71779,2443,0,0,0
88860,application_1508364558011_43921,1,77927,77927,88860,10933,10933,185,0,0,0
88884,application_1508364558011_46087,2,79095,79095,88884,9789,9789,22,0,0,0
88915,application_1508364558011_49155,1,85216,85216,88915,3699,3699,74,0,0,0
88936,application_1508364558011_48788,1,84843,84843,88936,4093,4093,33,0,0,0
88946,application_1508364558011_48070,1,83336,83336,88946,5610,5610,65,0,0,0
88956,application_1506638472019_19639,1,24933,24933,88956,64023,64023,1820,0,0,0
88956,application_1506638472019_19658,1,24936,24936,88956,64020,64020,1853,0,0,0
88956,application_1506638472019_6544,1,17078,17078,88956,71878,71878,2535,0,0,0
88976,application_1508364558011_9415,1,42064,42064,88976,46912,46912,1057,0,0,0
88986,application_1508364558011_48469,1,84566,84566,88986,4420,4420,72,0,0,0
88996,application_1508364558011_45094,1,78239,78239,88996,10757,10757,100,0,0,0
88996,application_1506638472019_6491,1,17072,17072,88996,71924,71924,2481,0,0,0
89006,application_1508364558011_45377,1,78268,78268,89006,10738,10738,133,0,0,0
89016,application_1508364558011_39930,1,73783,73783,89016,15233,15233,895,0,0,0
89016,application_1508364558011_38802,1,73596,73596,89016,15420,15420,267,0,0,0
89026,application_1508364558011_10077,1,42144,42144,89026,46882,46882,1368,0,0,0
89026,application_1508364558011_33862,1,69695,69695,89026,19331,19331,286,0,0,0
89026,application_1506638472019_19555,1,24920,24920,89026,64106,64106,1845,0,0,0
89026,application_1506638472019_19209,1,24848,24848,89026,64178,64178,1854,0,0,0
89026,application_1508364558011_12709,1,43627,43627,89026,45399,45399,1051,0,0,0
89036,application_1506638472019_19012,1,24811,24811,89036,64225,64225,1802,0,0,0
89036,application_1508364558011_29777,1,66200,66200,89036,22836,22836,437,0,0,0
89046,application_1508364558011_40166,1,73805,73805,89046,15241,15241,258,0,0,0
89046,application_1508364558011_8245,1,41626,41626,89046,47420,47420,998,0,0,0
89056,application_1508364558011_34210,1,69759,69759,89056,19297,19297,318,0,0,0
89066,application_1508364558011_47306,1,80508,80508,89066,8558,8558,79,0,0,0
89076,application_1508364558011_37352,1,72296,72296,89076,16780,16780,294,0,0,0
89096,application_1508364558011_38857,1,73600,73600,89096,15496,15496,315,0,0,0
89096,application_1506638472019_21364,1,26282,26282,89096,62814,62814,1478,0,0,0
89096,application_1506638472019_6572,1,17085,17085,89096,72011,72011,2565,0,0,0
89126,application_1506638472019_30252,1,30943,30943,89126,58183,58183,2143,0,0,0
89156,application_1508364558011_8305,1,41627,41627,89156,47529,47529,901,0,0,0
89156,application_1508364558011_33851,1,69694,69694,89156,19462,19462,318,0,0,0
89206,application_1508364558011_19835,1,49205,49205,89206,40001,40001,845,0,0,0
89226,application_1508364558011_37702,1,72325,72325,89226,16901,16901,258,0,0,0
89236,application_1508364558011_4217,1,39362,39362,89236,49874,49874,976,0,0,0
89246,application_1508364558011_39660,1,73760,73760,89246,15486,15486,210,0,0,0
89246,application_1508364558011_38811,1,73597,73597,89246,15649,15649,226,0,0,0
89266,application_1508364558011_10347,1,42149,42149,89266,47117,47117,1187,0,0,0
89266,application_1508364558011_48855,1,84903,84903,89266,4363,4363,58,0,0,0
89286,application_1508364558011_31214,1,67331,67331,89286,21955,21955,305,0,0,0
89286,application_1508364558011_44876,1,78223,78223,89286,11063,11063,149,0,0,0
89293,application_1508364558011_24422,1,56909,56909,89293,32384,32384,837,0,0,0
89321,application_1508364558011_47841,1,81776,81776,89321,7545,7545,69,0,0,0
89336,application_1508364558011_17509,1,47498,47498,89336,41838,41838,1650,0,0,0
89336,application_1508364558011_15068,1,45565,45565,89336,43771,43771,1369,0,0,0
89336,application_1508364558011_33853,1,69695,69695,89336,19641,19641,627,0,0,0
89346,application_1508364558011_43737,1,77910,77910,89346,11436,11436,212,0,0,0
89346,application_1508364558011_51997,1,87969,87969,89346,1377,1377,20,0,0,0
89376,application_1508364558011_34235,1,69761,69761,89376,19615,19615,393,0,0,0
89381,application_1506638472019_17775,1,24478,24478,89381,64903,64903,2056,0,0,0
89391,application_1508364558011_43568,1,77894,77894,89391,11497,11497,189,0,0,0
89391,application_1508364558011_48467,1,84566,84566,89391,4825,4825,56,0,0,0
89391,application_1508364558011_47719,1,81186,81186,89391,8205,8205,78,0,0,0
89401,application_1508364558011_43668,1,77903,77903,89401,11498,11498,167,0,0,0
89401,application_1506638472019_5284,1,15822,15822,89401,73579,73579,2544,0,0,0
89411,application_1508364558011_48018,1,82986,82986,89411,6425,6425,63,0,0,0
89411,application_1508364558011_48363,1,84326,84326,89411,5085,5085,56,0,0,0
89446,application_1506638472019_6858,1,17142,17142,89446,72304,72304,2491,0,0,0
89456,application_1508364558011_37399,1,72300,72300,89456,17156,17156,258,0,0,0
89476,application_1508364558011_44333,1,78145,78145,89476,11331,11331,368,0,0,0
89533,application_1508364558011_39839,1,73775,73775,89533,15758,15758,250,0,0,0
89533,application_1508364558011_16380,1,46505,46505,89533,43028,43028,1071,0,0,0
89582,application_1508364558011_9954,1,42140,42140,89582,47442,47442,944,0,0,0
89606,application_1508364558011_44949,1,78228,78228,89606,11378,11378,138,0,0,0
89616,application_1508364558011_43563,1,77894,77894,89616,11722,11722,218,0,0,0
89656,application_1508364558011_44987,1,78231,78231,89656,11425,11425,292,0,0,0
89656,application_1508364558011_47544,1,80736,80736,89656,8920,8920,64,0,0,0
89676,application_1508364558011_30016,1,66235,66235,89676,23441,23441,341,0,0,0
89686,application_1508364558011_30023,1,66236,66236,89686,23450,23450,480,0,0,0
89696,application_1508364558011_43857,1,77921,77921,89696,11775,11775,183,0,0,0
89696,application_1508364558011_37675,1,72323,72323,89696,17373,17373,225,0,0,0
89696,application_1508364558011_46385,1,79300,79300,89696,10396,10396,150,0,0,0
89706,application_1506638472019_19174,1,24842,24842,89706,64864,64864,1776,0,0,0
89746,application_1508364558011_46699,1,79642,79642,89746,10104,10104,180,0,0,0
89746,application_1508364558011_10035,1,42141,42141,89746,47605,47605,1169,0,0,0
89756,application_1508364558011_20983,1,50266,50266,89756,39490,39490,709,0,0,0
89766,application_1508364558011_24983,1,57400,57400,89766,32366,32366,729,0,0,0
89816,application_1508364558011_43895,1,77925,77925,89816,11891,11891,166,0,0,0
89816,application_1508364558011_21685,1,50966,50966,89816,38850,38850,715,0,0,0
89826,application_1506638472019_6426,1,17065,17065,89826,72761,72761,2574,0,0,0
89826,application_1508364558011_3302,1,39219,39219,89826,50607,50607,955,0,0,0
89836,application_1506638472019_6462,1,17068,17068,89836,72768,72768,2456,0,0,0
89836,application_1508364558011_48900,1,84956,84956,89836,4880,4880,60,0,0,0
89856,application_1508364558011_47914,1,82196,82196,89856,7660,7660,68,0,0,0
89856,application_1508364558011_12239,1,43509,43509,89856,46347,46347,1187,0,0,0
89856,application_1508364558011_33327,4,69425,69425,89856,20431,20431,122,0,0,0
89866,application_1508364558011_40182,1,73806,73806,89866,16060,16060,282,0,0,0
89886,application_1508364558011_11336,1,43061,43061,89886,46825,46825,892,0,0,0
89886,application_1506638472019_21460,1,26294,26294,89886,63592,63592,1491,0,0,0
89896,application_1506638472019_19426,1,24891,24891,89896,65005,65005,1965,0,0,0
89896,application_1508364558011_27267,1,60193,60193,89896,29703,29703,644,0,0,0
89906,application_1508364558011_17607,1,47664,47664,89906,42242,42242,1191,0,0,0
89906,application_1508364558011_48041,1,83156,83156,89906,6750,6750,62,0,0,0
89916,application_1508364558011_51859,1,87759,87759,89916,2157,2157,25,0,0,0
89916,application_1506638472019_3000,1,13360,13360,89916,76556,76556,3636,0,0,0
89986,application_1506638472019_7463,1,17220,17220,89986,72766,72766,2458,0,0,0
89996,application_1508364558011_40047,1,73795,73795,89996,16201,16201,200,0,0,0
89996,application_1508364558011_36817,1,71369,71369,89996,18627,18627,197,0,0,0
90016,application_1506638472019_19314,1,24868,24868,90016,65148,65148,1831,0,0,0
90026,application_1508364558011_39867,1,73777,73777,90026,16249,16249,275,0,0,0
90036,application_1508364558011_34908,1,69865,69865,90036,20171,20171,290,0,0,0
90046,application_1506638472019_21681,1,26315,26315,90046,63731,63731,1544,0,0,0
90046,application_1508364558011_52689,1,88916,88916,90046,1130,1130,62,0,0,0
90056,application_1508364558011_46505,1,79456,79456,90056,10600,10600,217,0,0,0
90056,application_1508364558011_8450,1,41642,41642,90056,48414,48414,1850,0,0,0
90056,application_1508364558011_48170,1,83766,83766,90056,6290,6290,65,0,0,0
90066,application_1508364558011_47873,1,81926,81926,90066,8140,8140,71,0,0,0
90066,application_1508364558011_8997,1,41851,41851,90066,48215,48215,927,0,0,0
90066,application_1508364558011_47990,1,82756,82756,90066,7310,7310,55,0,0,0
90086,application_1508364558011_11088,1,42995,42995,90086,47091,47091,1029,0,0,0
90096,application_1506638472019_7306,1,17172,17172,90096,72924,72924,2461,0,0,0
90106,application_1508364558011_47961,1,82526,82526,90106,7580,7580,68,0,0,0
90106,application_1508364558011_45532,1,78346,78346,90106,11760,11760,501,0,0,0
90116,application_1508364558011_7780,1,41525,41525,90116,48591,48591,1091,0,0,0
90116,application_1506638472019_18879,1,24785,24785,90116,65331,65331,1850,0,0,0
90116,application_1506638472019_9061,1,17577,17577,90116,72539,72539,2442,0,0,0
90116,application_1508364558011_7735,1,41523,41523,90116,48593,48593,1235,0,0,0
90136,application_1508364558011_14424,1,45026,45026,90136,45110,45110,1114,0,0,0
90146,application_1508364558011_4351,1,39365,39365,90146,50781,50781,1202,0,0,0
90146,application_1508364558011_17748,4,47766,47766,90146,42380,42380,154,0,0,0
90166,application_1508364558011_17127,1,47281,47281,90166,42885,42885,920,0,0,0
90166,application_1508364558011_13058,1,43948,43948,90166,46218,46218,987,0,0,0
90176,application_1506638472019_10628,1,18625,18625,90176,71551,71551,2335,0,0,0
90176,application_1508364558011_37299,1,72292,72292,90176,17884,17884,298,0,0,0
90196,application_1506638472019_7307,1,17172,17172,90196,73024,73024,2539,0,0,0
90216,application_1508364558011_5691,1,40039,40039,90216,50177,50177,976,0,0,0
90226,application_1508364558011_52687,1,88906,88906,90226,1320,1320,64,0,0,0
90256,application_1506638472019_21954,1,26357,26357,90256,63899,63899,1584,0,0,0
90256,application_1506638472019_18941,1,24796,24796,90256,65460,65460,1823,0,0,0
90266,application_1508364558011_10459,1,42163,42163,90266,48103,48103,1160,0,0,0
90266,application_1508364558011_44873,1,78223,78223,90266,12043,12043,188,0,0,0
90276,application_1506638472019_6640,1,17091,17091,90276,73185,73185,2512,0,0,0
90286,application_1508364558011_50331,1,86944,86944,90286,3342,3342,84,0,0,0
90296,application_1506638472019_34510,1,34576,34576,90296,55720,55720,1150,0,0,0
90310,application_1506638472019_19471,1,24904,24904,90310,65406,65406,1826,0,0,0
90320,application_1508364558011_35270,1,70062,70062,90320,20258,20258,197,0,0,0
90320,application_1508364558011_46857,2,79835,79835,90320,10485,10485,15,0,0,0
90330,application_1508364558011_17369,1,47416,47416,90330,42914,42914,816,0,0,0
90340,application_1506638472019_22208,1,26529,26529,90340,63811,63811,1533,0,0,0
90340,application_1506638472019_19903,1,25005,25005,90340,65335,65335,1828,0,0,0
90340,application_1508364558011_1832,1,38842,38842,90340,51498,51498,1290,0,0,0
90340,application_1506638472019_21378,1,26284,26284,90340,64056,64056,1540,0,0,0
90340,application_1508364558011_47084,2,80195,80195,90340,10145,10145,17,0,0,0
90350,application_1508364558011_8034,1,41622,41622,90350,48728,48728,1818,0,0,0
90350,application_1508364558011_40122,1,73801,73801,90350,16549,16549,319,0,0,0
90366,application_1508364558011_40183,1,73806,73806,90366,16560,16560,282,0,0,0
90366,application_1506638472019_19030,1,24814,24814,90366,65552,65552,1845,0,0,0
90375,application_1508364558011_47951,1,82436,82436,90375,7939,7939,63,0,0,0
90385,application_1508364558011_5730,1,40039,40039,90385,50346,50346,1000,0,0,0
90395,application_1508364558011_24976,1,57399,57399,90395,32996,32996,736,0,0,0
90415,application_1508364558011_50256,1,86846,86846,90415,3569,3569,61,0,0,0
90426,application_1508364558011_51802,1,87716,87716,90426,2710,2710,64,0,0,0
90436,application_1508364558011_11637,1,43302,43302,90436,47134,47134,1050,0,0,0
90456,application_1508364558011_37662,1,72322,72322,90456,18134,18134,311,0,0,0
90466,application_1508364558011_34522,1,69781,69781,90466,20685,20685,337,0,0,0
90476,application_1508364558011_5842,1,40042,40042,90476,50434,50434,1142,0,0,0
90496,application_1508364558011_44409,1,78154,78154,90496,12342,12342,264,0,0,0
90506,application_1508364558011_2383,1,39006,39006,90506,51500,51500,1544,0,0,0
90506,application_1506638472019_20241,1,25522,25522,90506,64984,64984,1591,0,0,0
90516,application_1508364558011_33819,1,69691,69691,90516,20825,20825,388,0,0,0
90536,application_1506638472019_7312,1,17173,17173,90536,73363,73363,2478,0,0,0
90566,application_1508364558011_8675,1,41646,41646,90566,48920,48920,1310,0,0,0
90626,application_1508364558011_1668,1,38782,38782,90626,51844,51844,993,0,0,0
90636,application_1506638472019_19045,1,24816,24816,90636,65820,65820,1884,0,0,0
90666,application_1508364558011_48059,1,83256,83256,90666,7410,7410,63,0,0,0
90696,application_1508364558011_44307,1,78142,78142,90696,12554,12554,269,0,0,0
90696,application_1508364558011_37409,1,72301,72301,90696,18395,18395,261,0,0,0
90706,application_1508364558011_42327,1,76220,76220,90706,14486,14486,439,0,0,0
90716,application_1506638472019_7389,1,17211,17211,90716,73505,73505,2449,0,0,0
90726,application_1508364558011_45077,1,78238,78238,90726,12488,12488,222,0,0,0
90726,application_1508364558011_48404,1,84526,84526,90726,6200,6200,54,0,0,0
90756,application_1506638472019_18522,1,24605,24605,90756,66151,66151,2126,0,0,0
90776,application_1506638472019_18868,1,24782,24782,90776,65994,65994,1896,0,0,0
90776,application_1508364558011_37494,1,72308,72308,90776,18468,18468,320,0,0,0
90796,application_1508364558011_40090,1,73799,73799,90796,16997,16997,301,0,0,0
90806,application_1508364558011_3654,1,39255,39255,90806,51551,51551,1369,0,0,0
90827,application_1508364558011_4385,1,39365,39365,90827,51462,51462,1243,0,0,0
90837,application_1508364558011_46326,1,79258,79258,90837,11579,11579,156,0,0,0
90837,application_1508364558011_39840,1,73775,73775,90837,17062,17062,310,0,0,0
90846,application_1506638472019_8963,1,17563,17563,90846,73283,73283,2683,0,0,0
90846,application_1506638472019_6591,1,17086,17086,90846,73760,73760,2442,0,0,0
90866,application_1508364558011_23242,1,55849,55849,90866,35017,35017,668,0,0,0
90886,application_1508364558011_48128,1,83646,83646,90886,7240,7240,75,0,0,0
90906,application_1508364558011_17123,1,47281,47281,90906,43625,43625,800,0,0,0
90906,application_1508364558011_50847,1,87266,87266,90906,3640,3640,64,0,0,0
90906,application_1506638472019_22179,1,26525,26525,90906,64381,64381,1542,0,0,0
90906,application_1506638472019_19887,1,25002,25002,90906,65904,65904,1801,0,0,0
90926,application_1508364558011_39039,1,73615,73615,90926,17311,17311,308,0,0,0
90926,application_1506638472019_12390,1,18870,18870,90926,72056,72056,2559,0,0,0
90936,application_1508364558011_34503,1,69780,69780,90936,21156,21156,605,0,0,0
90956,application_1508364558011_18475,1,47974,47974,90956,42982,42982,991,0,0,0
90956,application_1508364558011_49331,1,85446,85446,90956,5510,5510,56,0,0,0
90966,application_1506638472019_8821,1,17541,17541,90966,73425,73425,2629,0,0,0
91006,application_1508364558011_48437,1,84565,84565,91006,6441,6441,75,0,0,0
91006,application_1508364558011_8235,1,41625,41625,91006,49381,49381,1154,0,0,0
91036,application_1508364558011_20949,1,50265,50265,91036,40771,40771,1678,0,0,0
91046,application_1506638472019_30126,1,30928,30928,91046,60118,60118,2069,0,0,0
91056,application_1506638472019_9017,1,17570,17570,91056,73486,73486,2713,0,0,0
91056,application_1508364558011_16160,1,46393,46393,91056,44663,44663,1302,0,0,0
91084,application_1508364558011_50408,1,87166,87166,91084,3918,3918,68,0,0,0
91084,application_1508364558011_14130,1,44890,44890,91084,46194,46194,930,0,0,0
91100,application_1506638472019_18986,1,24805,24805,91100,66295,66295,1899,0,0,0
91130,application_1508364558011_40420,1,73904,73904,91130,17226,17226,371,0,0,0
91150,application_1508364558011_33888,1,69698,69698,91150,21452,21452,514,0,0,0
91166,application_1508364558011_52335,1,88226,88226,91166,2940,2940,61,0,0,0
91166,application_1506638472019_19351,1,24874,24874,91166,66292,66292,1887,0,0,0
91166,application_1506638472019_22285,1,26537,26537,91166,64629,64629,1536,0,0,0
91166,application_1508364558011_13887,1,44775,44775,91166,46391,46391,1086,0,0,0
91166,application_1508364558011_47177,2,80279,80279,91166,10887,10887,23,0,0,0
91186,application_1508364558011_4767,1,39805,39805,91186,51381,51381,1127,0,0,0
91186,application_1508364558011_14137,1,44891,44891,91186,46295,46295,909,0,0,0
91186,application_1508364558011_52926,1,89506,89506,91186,1680,1680,61,0,0,0
91186,application_1508364558011_52606,1,88756,88756,91186,2430,2430,68,0,0,0
91196,application_1508364558011_44438,1,78156,78156,91196,13040,13040,231,0,0,0
91196,application_1508364558011_47716,2,81166,81166,91196,10030,10030,23,0,0,0
91216,application_1508364558011_45344,1,78264,78264,91216,12952,12952,178,0,0,0
91226,application_1508364558011_29895,1,66217,66217,91226,25009,25009,505,0,0,0
91226,application_1506638472019_21995,1,26361,26361,91226,64865,64865,1561,0,0,0
91226,application_1508364558011_48436,2,84564,84564,91226,6662,6662,30,0,0,0
91236,application_1508364558011_50929,1,87276,87276,91236,3960,3960,71,0,0,0
91256,application_1508364558011_48451,2,84566,84566,91256,6690,6690,26,0,0,0
91266,application_1508364558011_8346,1,41627,41627,91266,49639,49639,1026,0,0,0
91276,application_1508364558011_49169,2,85239,85239,91276,6037,6037,13,0,0,0
91286,application_1508364558011_8599,1,41644,41644,91286,49642,49642,1133,0,0,0
91316,application_1508364558011_14368,1,45001,45001,91316,46315,46315,984,0,0,0
91326,application_1508364558011_10622,1,42169,42169,91326,49157,49157,974,0,0,0
91326,application_1508364558011_43530,1,77891,77891,91326,13435,13435,167,0,0,0
91336,application_1506638472019_7432,1,17217,17217,91336,74119,74119,2478,0,0,0
91361,application_1506638472019_18154,1,24538,24538,91361,66823,66823,2063,0,0,0
91371,application_1508364558011_48360,1,84306,84306,91371,7065,7065,62,0,0,0
91371,application_1508364558011_51895,1,87820,87820,91371,3551,3551,76,0,0,0
91386,application_1506638472019_23496,1,27200,27200,91386,64186,64186,2599,0,0,0
91386,application_1508364558011_9878,1,42139,42139,91386,49247,49247,986,0,0,0
91411,application_1506638472019_39113,1,37059,37059,91411,54352,54352,1279,0,0,0
91411,application_1508364558011_29846,1,66211,66211,91411,25200,25200,475,0,0,0
91411,application_1508364558011_44265,1,78139,78139,91411,13272,13272,268,0,0,0
91411,application_1508364558011_27294,1,60198,60198,91411,31213,31213,626,0,0,0
91421,application_1508364558011_44938,1,78227,78227,91421,13194,13194,229,0,0,0
91421,application_1508364558011_43817,1,77918,77918,91421,13503,13503,236,0,0,0
91421,application_1508364558011_6610,1,40812,40812,91421,50609,50609,887,0,0,0
91441,application_1508364558011_40613,1,74012,74012,91441,17429,17429,794,0,0,0
91451,application_1508364558011_7259,1,41280,41280,91451,50171,50171,1428,0,0,0
91451,application_1508364558011_24980,1,57399,57399,91451,34052,34052,761,0,0,0
91458,application_1508364558011_51700,1,87586,87586,91458,3872,3872,68,0,0,0
91468,application_1506638472019_37059,1,35536,35536,91468,55932,55932,1223,0,0,0
91488,application_1508364558011_10042,1,42141,42141,91488,49347,49347,1059,0,0,0
91488,application_1508364558011_11033,1,42908,42908,91488,48580,48580,923,0,0,0
91498,application_1508364558011_37436,1,72304,72304,91498,19194,19194,309,0,0,0
91508,application_1506638472019_19924,1,25009,25009,91508,66499,66499,1872,0,0,0
91518,application_1506638472019_6579,1,17085,17085,91518,74433,74433,2486,0,0,0
91528,application_1508364558011_44465,1,78158,78158,91528,13370,13370,269,0,0,0
91548,application_1506638472019_2631,1,13295,13295,91548,78253,78253,3635,0,0,0
91568,application_1506638472019_30184,1,30935,30935,91568,60633,60633,1958,0,0,0
91568,application_1508364558011_49284,1,85386,85386,91568,6182,6182,66,0,0,0
91578,application_1508364558011_51335,1,87416,87416,91578,4162,4162,57,0,0,0
91588,application_1508364558011_50056,1,86576,86576,91588,5012,5012,62,0,0,0
91588,application_1508364558011_44864,1,78222,78222,91588,13366,13366,139,0,0,0
91598,application_1508364558011_39013,1,73613,73613,91598,17985,17985,384,0,0,0
91618,application_1506638472019_18671,1,24621,24621,91618,66997,66997,1992,0,0,0
91648,application_1506638472019_7311,1,17173,17173,91648,74475,74475,2511,0,0,0
91648,application_1508364558011_50286,1,86886,86886,91648,4762,4762,70,0,0,0
91648,application_1508364558011_37303,1,72292,72292,91648,19356,19356,310,0,0,0
91668,application_1506638472019_6875,1,17144,17144,91668,74524,74524,2611,0,0,0
91678,application_1508364558011_52053,1,88056,88056,91678,3622,3622,72,0,0,0
91678,application_1506638472019_7296,1,17171,17171,91678,74507,74507,2441,0,0,0
91718,application_1508364558011_32618,1,68790,68790,91718,22928,22928,424,0,0,0
91728,application_1508364558011_8318,1,41627,41627,91728,50101,50101,1020,0,0,0
91766,application_1506638472019_8081,1,17287,17287,91766,74479,74479,2611,0,0,0
91766,application_1506638472019_5393,1,15892,15892,91766,75874,75874,2601,0,0,0
91776,application_1508364558011_12174,1,43506,43506,91776,48270,48270,1153,0,0,0
91786,application_1508364558011_43906,1,77926,77926,91786,13860,13860,269,0,0,0
91796,application_1508364558011_49361,1,85496,85496,91796,6300,6300,63,0,0,0
91820,application_1508364558011_49499,2,85886,85886,91820,5934,5934,11,0,0,0
91826,application_1508364558011_44421,1,78155,78155,91826,13671,13671,264,0,0,0
91846,application_1508364558011_49418,1,85606,85606,91846,6240,6240,64,0,0,0
91846,application_1508364558011_6751,1,40814,40814,91846,51032,51032,1116,0,0,0
91846,application_1508364558011_49519,2,85976,85976,91846,5870,5870,26,0,0,0
91856,application_1508364558011_13875,1,44722,44722,91856,47134,47134,1670,0,0,0
91862,application_1508364558011_37244,1,72287,72287,91862,19575,19575,296,0,0,0
91872,application_1508364558011_50543,1,87226,87226,91872,4646,4646,62,0,0,0
91872,application_1508364558011_16648,1,46688,46688,91872,45184,45184,1756,0,0,0
91872,application_1511528684064_0007,1,90046,90046,91872,1826,1826,74,0,0,0
91876,application_1508364558011_38813,1,73597,73597,91876,18279,18279,321,0,0,0
91924,application_1506638472019_9002,1,17569,17569,91924,74355,74355,2637,0,0,0
91924,application_1506638472019_19429,1,24891,24891,91924,67033,67033,1807,0,0,0
91946,application_1508364558011_48426,1,84564,84564,91946,7382,7382,72,0,0,0
91946,application_1506638472019_7331,1,17175,17175,91946,74771,74771,2522,0,0,0
92006,application_1508364558011_52742,1,89156,89156,92006,2850,2850,68,0,0,0
92026,application_1511528684064_0176,1,90966,90966,92026,1060,1060,68,0,0,0
92066,application_1508364558011_51719,1,87616,87616,92066,4450,4450,73,0,0,0
92076,application_1508364558011_43681,1,77904,77904,92076,14172,14172,322,0,0,0
92076,application_1508364558011_53083,1,89836,89836,92076,2240,2240,50,0,0,0
92096,application_1511528684064_0015,1,90116,90116,92096,1980,1980,79,0,0,0
92096,application_1508364558011_18852,1,48070,48070,92096,44026,44026,1207,0,0,0
92126,application_1508364558011_50369,1,87046,87046,92126,5080,5080,55,0,0,0
92136,application_1506638472019_5584,1,15898,15898,92136,76238,76238,3863,0,0,0
92146,application_1508364558011_33583,1,69527,69527,92146,22619,22619,858,0,0,0
92156,application_1511528684064_0069,1,90426,90426,92156,1730,1730,83,0,0,0
92156,application_1506638472019_4852,1,15804,15804,92156,76352,76352,2839,0,0,0
92176,application_1508364558011_16024,1,46364,46364,92176,45812,45812,1219,0,0,0
92176,application_1508364558011_52780,1,89266,89266,92176,2910,2910,62,0,0,0
92186,application_1508364558011_39042,1,73615,73615,92186,18571,18571,510,0,0,0
92196,application_1508364558011_18833,1,48069,48069,92196,44127,44127,1071,0,0,0
92216,application_1508364558011_48805,1,84854,84854,92216,7362,7362,38,0,0,0
92226,application_1506638472019_7590,1,17233,17233,92226,74993,74993,2470,0,0,0
92226,application_1508364558011_18981,1,48249,48249,92226,43977,43977,1375,0,0,0
92246,application_1508364558011_3232,1,39217,39217,92246,53029,53029,1098,0,0,0
92246,application_1508364558011_49928,1,86386,86386,92246,5860,5860,82,0,0,0
92256,application_1511528684064_0140,1,90746,90746,92256,1510,1510,57,0,0,0
92256,application_1508364558011_29764,1,66196,66196,92256,26060,26060,424,0,0,0
92266,application_1508364558011_45058,1,78236,78236,92266,14030,14030,298,0,0,0
92286,application_1506638472019_2632,1,13295,13295,92286,78991,78991,3677,0,0,0
92296,application_1506638472019_7053,1,17156,17156,92296,75140,75140,2586,0,0,0
92346,application_1508364558011_48385,1,84446,84446,92346,7900,7900,66,0,0,0
92346,application_1508364558011_9480,1,42065,42065,92346,50281,50281,1065,0,0,0
92346,application_1508364558011_29900,1,66218,66218,92346,26128,26128,440,0,0,0
92366,application_1506638472019_30690,1,31014,31014,92366,61352,61352,2099,0,0,0
92366,application_1508364558011_44257,1,78138,78138,92366,14228,14228,229,0,0,0
92366,application_1506638472019_6486,1,17072,17072,92366,75294,75294,2500,0,0,0
92376,application_1508364558011_4751,1,39805,39805,92376,52571,52571,1365,0,0,0
92386,application_1508364558011_52636,1,88857,88857,92386,3529,3529,107,0,0,0
92396,application_1508364558011_44554,1,78165,78165,92396,14231,14231,265,0,0,0
92396,application_1508364558011_4850,1,39809,39809,92396,52587,52587,1119,0,0,0
92396,application_1506638472019_7082,1,17158,17158,92396,75238,75238,2494,0,0,0
92406,application_1508364558011_2682,1,39058,39058,92406,53348,53348,949,0,0,0
92416,application_1506638472019_19109,1,24827,24827,92416,67589,67589,1855,0,0,0
92436,application_1508364558011_9413,1,42064,42064,92436,50372,50372,1277,0,0,0
92436,application_1508364558011_45045,1,78235,78235,92436,14201,14201,275,0,0,0
92436,application_1508364558011_44549,1,78164,78164,92436,14272,14272,266,0,0,0
92446,application_1508364558011_4611,1,39800,39800,92446,52646,52646,1934,0,0,0
92456,application_1506638472019_6641,1,17091,17091,92456,75365,75365,2477,0,0,0
92466,application_1508364558011_45425,1,78324,78324,92466,14142,14142,419,0,0,0
92469,application_1508364558011_52817,1,89326,89326,92469,3143,3143,56,0,0,0
92489,application_1506638472019_6852,1,17141,17141,92489,75348,75348,2524,0,0,0
92489,application_1508364558011_52622,1,88826,88826,92489,3663,3663,63,0,0,0
92509,application_1511528684064_0040,1,90266,90266,92509,2243,2243,75,0,0,0
92509,application_1508364558011_8279,1,41626,41626,92509,50883,50883,1603,0,0,0
92539,application_1508364558011_9614,1,42067,42067,92539,50472,50472,1163,0,0,0
92581,application_1508364558011_37649,1,72321,72321,92581,20260,20260,732,0,0,0
92616,application_1508364558011_47424,1,80558,80558,92616,12058,12058,125,0,0,0
92626,application_1506638472019_8839,1,17544,17544,92626,75082,75082,2532,0,0,0
92626,application_1508364558011_4376,1,39365,39365,92626,53261,53261,1281,0,0,0
92626,application_1506638472019_19173,1,24842,24842,92626,67784,67784,1860,0,0,0
92636,application_1506638472019_19969,1,25056,25056,92636,67580,67580,1879,0,0,0
92685,application_1506638472019_9105,1,17584,17584,92685,75101,75101,2721,0,0,0
92685,application_1506638472019_16727,1,23279,23279,92685,69406,69406,2771,0,0,0
92685,application_1506638472019_30981,1,31045,31045,92685,61640,61640,2085,0,0,0
92697,application_1506638472019_28400,1,29153,29153,92697,63544,63544,2276,0,0,0
92706,application_1508364558011_48440,1,84565,84565,92706,8141,8141,71,0,0,0
92706,application_1508364558011_44368,1,78151,78151,92706,14555,14555,266,0,0,0
92726,application_1508364558011_29924,1,66222,66222,92726,26504,26504,476,0,0,0
92746,application_1508364558011_43661,1,77903,77903,92746,14843,14843,173,0,0,0
92776,application_1508364558011_37268,1,72289,72289,92776,20487,20487,305,0,0,0
92776,application_1508364558011_50106,1,86656,86656,92776,6120,6120,66,0,0,0
92776,application_1508364558011_8201,1,41625,41625,92776,51151,51151,1383,0,0,0
92776,application_1508364558011_37371,1,72298,72298,92776,20478,20478,505,0,0,0
92786,application_1506638472019_22447,1,26568,26568,92786,66218,66218,1592,0,0,0
92786,application_1508364558011_45387,1,78270,78270,92786,14516,14516,261,0,0,0
92796,application_1506638472019_6407,1,17063,17063,92796,75733,75733,2419,0,0,0
92806,application_1506638472019_21634,1,26310,26310,92806,66496,66496,1579,0,0,0
92816,application_1508364558011_48158,1,83748,83748,92816,9068,9068,180,0,0,0
92826,application_1508364558011_45196,1,78250,78250,92826,14576,14576,185,0,0,0
92856,application_1508364558011_27863,1,62002,62002,92856,30854,30854,530,0,0,0
92856,application_1506638472019_32915,1,33610,33610,92856,59246,59246,1224,0,0,0
92876,application_1508364558011_33858,1,69695,69695,92876,23181,23181,305,0,0,0
92886,application_1508364558011_4416,1,39366,39366,92886,53520,53520,1150,0,0,0
92886,application_1508364558011_49071,4,85115,85115,92886,7771,7771,85,0,0,0
92896,application_1506638472019_6761,1,17130,17130,92896,75766,75766,2630,0,0,0
92906,application_1508364558011_52066,1,88083,88083,92906,4823,4823,109,0,0,0
92926,application_1506638472019_7905,1,17269,17269,92926,75657,75657,2646,0,0,0
92956,application_1508364558011_29947,1,66225,66225,92956,26731,26731,483,0,0,0
92976,application_1508364558011_36373,1,70634,70634,92976,22342,22342,422,0,0,0
92976,application_1508364558011_14445,1,45027,45027,92976,47949,47949,1358,0,0,0
93026,application_1508364558011_52816,1,89321,89321,93026,3705,3705,102,0,0,0
93046,application_1511528684064_0233,1,91156,91156,93046,1890,1890,62,0,0,0
93066,application_1506638472019_6926,1,17148,17148,93066,75918,75918,2543,0,0,0
93076,application_1508364558011_38849,1,73600,73600,93076,19476,19476,262,0,0,0
93076,application_1506638472019_6595,1,17086,17086,93076,75990,75990,2548,0,0,0
93086,application_1508364558011_2012,1,38857,38857,93086,54229,54229,1061,0,0,0
93086,application_1508364558011_35862,1,70148,70148,93086,22938,22938,318,0,0,0
93096,application_1506638472019_6568,1,17084,17084,93096,76012,76012,2464,0,0,0
93116,application_1506638472019_21530,1,26300,26300,93116,66816,66816,1497,0,0,0
93116,application_1506638472019_6844,1,17141,17141,93116,75975,75975,2635,0,0,0
93146,application_1506638472019_30576,1,30999,30999,93146,62147,62147,1989,0,0,0
93146,application_1508364558011_11160,1,42998,42998,93146,50148,50148,989,0,0,0
93156,application_1506638472019_22121,1,26518,26518,93156,66638,66638,1631,0,0,0
93156,application_1508364558011_3679,1,39256,39256,93156,53900,53900,1176,0,0,0
93192,application_1508364558011_36638,1,71021,71021,93192,22171,22171,497,0,0,0
93192,application_1508364558011_45418,1,78308,78308,93192,14884,14884,325,0,0,0
93212,application_1508364558011_37137,4,72141,72141,93212,21071,21071,156,0,0,0
93222,application_1508364558011_44375,1,78151,78151,93222,15071,15071,265,0,0,0
93232,application_1508364558011_41965,1,75600,75600,93232,17632,17632,212,0,0,0
93272,application_1508364558011_29825,1,66207,66207,93272,27065,27065,431,0,0,0
93296,application_1508364558011_52698,1,88946,88946,93296,4350,4350,66,0,0,0
93296,application_1508364558011_45087,1,78238,78238,93296,15058,15058,181,0,0,0
93316,application_1508364558011_36157,8,70448,70448,93316,22868,22868,72,0,0,0
93326,application_1508364558011_37267,1,72289,72289,93326,21037,21037,401,0,0,0
93336,application_1506638472019_19592,1,24925,24925,93336,68411,68411,1850,0,0,0
93346,application_1506638472019_18311,1,24571,24571,93346,68775,68775,2096,0,0,0
93356,application_1506638472019_12285,1,18854,18854,93356,74502,74502,2358,0,0,0
93366,application_1508364558011_52012,1,87986,87986,93366,5380,5380,63,0,0,0
93376,application_1506638472019_6514,1,17074,17074,93376,76302,76302,2505,0,0,0
93426,application_1506638472019_19322,1,24869,24869,93426,68557,68557,1815,0,0,0
93426,application_1508364558011_50046,1,86556,86556,93426,6870,6870,69,0,0,0
93436,application_1506638472019_8989,1,17567,17567,93436,75869,75869,2710,0,0,0
93456,application_1508364558011_48013,1,82959,82959,93456,10497,10497,73,0,0,0
93456,application_1506638472019_20010,1,25110,25110,93456,68346,68346,1819,0,0,0
93496,application_1506638472019_19594,1,24925,24925,93496,68571,68571,1881,0,0,0
93506,application_1511528684064_0207,1,91086,91086,93506,2420,2420,70,0,0,0
93506,application_1508364558011_8045,1,41623,41623,93506,51883,51883,1374,0,0,0
93516,application_1506638472019_3592,1,13530,13530,93516,79986,79986,3625,0,0,0
93516,application_1508364558011_49076,4,85116,85116,93516,8400,8400,68,0,0,0
93536,application_1506638472019_8180,1,17298,17298,93536,76238,76238,2750,0,0,0
93536,application_1508364558011_37351,1,72296,72296,93536,21240,21240,328,0,0,0
93536,application_1506638472019_6482,1,17071,17071,93536,76465,76465,2526,0,0,0
93536,application_1511528684064_0094,1,90566,90566,93536,2970,2970,74,0,0,0
93546,application_1508364558011_49122,1,85166,85166,93546,8380,8380,64,0,0,0
93546,application_1508364558011_9586,1,42067,42067,93546,51479,51479,1138,0,0,0
93556,application_1506638472019_18001,1,24513,24513,93556,69043,69043,2044,0,0,0
93566,application_1508364558011_49811,1,86341,86341,93566,7225,7225,90,0,0,0
93576,application_1508364558011_49084,1,85124,85124,93576,8452,8452,58,0,0,0
93595,application_1508364558011_14453,1,45028,45028,93595,48567,48567,1144,0,0,0
93595,application_1508364558011_3944,1,39298,39298,93595,54297,54297,1263,0,0,0
93606,application_1506638472019_19072,1,24821,24821,93606,68785,68785,1887,0,0,0
93616,application_1506638472019_19817,1,24987,24987,93616,68629,68629,1852,0,0,0
93616,application_1508364558011_8205,1,41625,41625,93616,51991,51991,1046,0,0,0
93626,application_1508364558011_37608,1,72317,72317,93626,21309,21309,260,0,0,0
93636,application_1508364558011_24965,1,57398,57398,93636,36238,36238,1148,0,0,0
93646,application_1511528684064_0277,1,91376,91376,93646,2270,2270,72,0,0,0
93656,application_1508364558011_2128,1,38993,38993,93656,54663,54663,1833,0,0,0
93666,application_1508364558011_43637,1,77901,77901,93666,15765,15765,191,0,0,0
93666,application_1508364558011_48853,1,84903,84903,93666,8763,8763,63,0,0,0
93696,application_1508364558011_17411,1,47463,47463,93696,46233,46233,1153,0,0,0
93706,application_1508364558011_48725,1,84736,84736,93706,8970,8970,61,0,0,0
93706,application_1508364558011_21138,1,50536,50536,93706,43170,43170,793,0,0,0
93777,application_1508364558011_48361,1,84316,84316,93777,9461,9461,62,0,0,0
93806,application_1508364558011_6707,1,40814,40814,93806,52992,52992,1249,0,0,0
93824,application_1508364558011_44369,1,78151,78151,93824,15673,15673,299,0,0,0
93844,application_1508364558011_7768,1,41524,41524,93844,52320,52320,1198,0,0,0
93853,application_1511528684064_0154,1,90846,90846,93853,3007,3007,66,0,0,0
93863,application_1506638472019_17762,1,24476,24476,93863,69387,69387,2139,0,0,0
93942,application_1511528684064_0279,1,91391,91391,93942,2551,2551,100,0,0,0
93962,application_1508364558011_10271,1,42148,42148,93962,51814,51814,1044,0,0,0
93962,application_1508364558011_27326,1,60203,60203,93962,33759,33759,675,0,0,0
93992,application_1508364558011_10294,1,42148,42148,93992,51844,51844,1105,0,0,0
93998,application_1508364558011_48155,1,83748,83748,93998,10250,10250,188,0,0,0
94008,application_1508364558011_37500,1,72308,72308,94008,21700,21700,421,0,0,0
94028,application_1508364558011_8970,1,41850,41850,94028,52178,52178,1174,0,0,0
94048,application_1506638472019_22016,1,26364,26364,94048,67684,67684,1554,0,0,0
94068,application_1508364558011_52078,1,88106,88106,94068,5962,5962,75,0,0,0
94078,application_1508364558011_11233,1,43015,43015,94078,51063,51063,984,0,0,0
94078,application_1508364558011_36678,8,71100,71100,94078,22978,22978,208,0,0,0
94088,application_1508364558011_44484,1,78160,78160,94088,15928,15928,264,0,0,0
94108,application_1506638472019_6901,1,17147,17147,94108,76961,76961,2475,0,0,0
94118,application_1506638472019_5956,1,16167,16167,94118,77951,77951,2726,0,0,0
94126,application_1508364558011_29763,1,66196,66196,94126,27930,27930,445,0,0,0
94136,application_1508364558011_39677,1,73761,73761,94136,20375,20375,390,0,0,0
94158,application_1508364558011_24783,1,57371,57371,94158,36787,36787,734,0,0,0
94168,application_1506638472019_18211,1,24543,24543,94168,69625,69625,2091,0,0,0
94178,application_1508364558011_11445,1,43293,43293,94178,50885,50885,1148,0,0,0
94188,application_1508364558011_43609,1,77898,77898,94188,16290,16290,334,0,0,0
94206,application_1508364558011_39125,1,73622,73622,94206,20584,20584,386,0,0,0
94206,application_1511528684064_0532,1,92766,92766,94206,1440,1440,55,0,0,0
94216,application_1508364558011_44287,1,78141,78141,94216,16075,16075,309,0,0,0
94276,application_1508364558011_52368,1,88276,88276,94276,6000,6000,62,0,0,0
94276,application_1506638472019_7641,1,17239,17239,94276,77037,77037,2653,0,0,0
94286,application_1508364558011_52968,1,89596,89596,94286,4690,4690,70,0,0,0
94286,application_1508364558011_43691,1,77905,77905,94286,16381,16381,248,0,0,0
94316,application_1508364558011_42326,1,76220,76220,94316,18096,18096,439,0,0,0
94336,application_1508364558011_43744,1,77911,77911,94336,16425,16425,239,0,0,0
94356,application_1508364558011_29785,1,66201,66201,94356,28155,28155,496,0,0,0
94366,application_1506638472019_11821,1,18784,18784,94366,75582,75582,2569,0,0,0
94386,application_1506638472019_5279,1,15822,15822,94386,78564,78564,2784,0,0,0
94386,application_1506638472019_30070,1,30922,30922,94386,63464,63464,2003,0,0,0
94386,application_1506638472019_18147,1,24537,24537,94386,69849,69849,2137,0,0,0
94386,application_1511528684064_0420,1,92256,92256,94386,2130,2130,65,0,0,0
94386,application_1511528684064_0213,1,91088,91088,94386,3298,3298,63,0,0,0
94386,application_1508364558011_11611,1,43301,43301,94386,51085,51085,1027,0,0,0
94406,application_1508364558011_27255,1,60191,60191,94406,34215,34215,643,0,0,0
94406,application_1511528684064_0365,1,91876,91876,94406,2530,2530,66,0,0,0
94416,application_1508364558011_49775,1,86286,86286,94416,8130,8130,64,0,0,0
94436,application_1511528684064_0200,1,91066,91066,94436,3370,3370,83,0,0,0
94436,application_1508364558011_50292,1,86897,86897,94436,7539,7539,221,0,0,0
94446,application_1511528684064_0510,1,92687,92687,94446,1759,1759,52,0,0,0
94506,application_1511528684064_0447,1,92446,92446,94506,2060,2060,70,0,0,0
94516,application_1511528684064_0342,1,91756,91756,94516,2760,2760,71,0,0,0
94526,application_1508364558011_23214,1,55846,55846,94526,38680,38680,723,0,0,0
94526,application_1508364558011_49442,1,85686,85686,94526,8840,8840,86,0,0,0
94526,application_1511528684064_0027,1,90186,90186,94526,4340,4340,82,0,0,0
94536,application_1508364558011_37336,1,72295,72295,94536,22241,22241,1084,0,0,0
94546,application_1508364558011_40363,1,73899,73899,94546,20647,20647,910,0,0,0
94556,application_1508364558011_37283,1,72290,72290,94556,22266,22266,736,0,0,0
94566,application_1508364558011_43917,1,77927,77927,94566,16639,16639,315,0,0,0
94596,application_1506638472019_19804,1,24985,24985,94596,69611,69611,1828,0,0,0
94596,application_1508364558011_45895,1,78888,78888,94596,15708,15708,301,0,0,0
94596,application_1506638472019_19987,1,25064,25064,94596,69532,69532,1951,0,0,0
94616,application_1508364558011_44289,1,78141,78141,94616,16475,16475,260,0,0,0
94629,application_1511528684064_0492,1,92616,92616,94629,2013,2013,67,0,0,0
94650,application_1506638472019_7519,1,17226,17226,94650,77424,77424,2526,0,0,0
94695,application_1508364558011_24432,1,56910,56910,94695,37785,37785,695,0,0,0
94723,application_1508364558011_47882,1,81974,81974,94723,12749,12749,81,0,0,0
94733,application_1508364558011_3631,1,39254,39254,94733,55479,55479,1201,0,0,0
94766,application_1508364558011_51747,1,87688,87688,94766,7078,7078,76,0,0,0
94776,application_1506638472019_7818,1,17263,17263,94776,77513,77513,2478,0,0,0
94786,application_1508364558011_13483,1,44656,44656,94786,50130,50130,1200,0,0,0
94796,application_1511528684064_0499,1,92641,92641,94796,2155,2155,58,0,0,0
94816,application_1508364558011_4759,1,39805,39805,94816,55011,55011,1062,0,0,0
94816,application_1506638472019_28654,1,29205,29205,94816,65611,65611,2411,0,0,0
94824,application_1508364558011_7770,1,41524,41524,94824,53300,53300,1448,0,0,0
94854,application_1508364558011_52540,1,88536,88536,94854,6318,6318,79,0,0,0
94854,application_1508364558011_9441,1,42065,42065,94854,52789,52789,1191,0,0,0
94873,application_1508364558011_9625,1,42067,42067,94873,52806,52806,1339,0,0,0
94889,application_1506638472019_5514,1,15896,15896,94889,78993,78993,3680,0,0,0
94899,application_1508364558011_10389,1,42150,42150,94899,52749,52749,1168,0,0,0
94909,application_1506638472019_19343,1,24872,24872,94909,70037,70037,1928,0,0,0
94926,application_1508364558011_14353,1,45001,45001,94926,49925,49925,977,0,0,0
94946,application_1508364558011_15239,1,45567,45567,94946,49379,49379,994,0,0,0
94967,application_1511528684064_0202,1,91084,91084,94967,3883,3883,80,0,0,0
94967,application_1506638472019_17868,1,24497,24497,94967,70470,70470,2133,0,0,0
94984,application_1508364558011_8548,1,41643,41643,94984,53341,53341,1287,0,0,0
94994,application_1508364558011_8544,1,41643,41643,94994,53351,53351,1035,0,0,0
95004,application_1511528684064_0264,1,91316,91316,95004,3688,3688,64,0,0,0
95024,application_1506638472019_19464,1,24902,24902,95024,70122,70122,1856,0,0,0
95034,application_1506638472019_19430,1,24892,24892,95034,70142,70142,1888,0,0,0
95034,application_1508364558011_8026,1,41622,41622,95034,53412,53412,1426,0,0,0
95034,application_1508364558011_36738,8,71252,71252,95034,23782,23782,42,0,0,0
95077,application_1506638472019_18071,1,24519,24519,95077,70558,70558,2025,0,0,0
95087,application_1506638472019_6664,1,17093,17093,95087,77994,77994,2559,0,0,0
95097,application_1506638472019_25820,1,27939,27939,95097,67158,67158,1764,0,0,0
95097,application_1508364558011_12073,1,43471,43471,95097,51626,51626,1014,0,0,0
95117,application_1508364558011_20053,1,49258,49258,95117,45859,45859,1389,0,0,0
95127,application_1508364558011_7149,1,41278,41278,95127,53849,53849,1405,0,0,0
95137,application_1506638472019_11469,1,18726,18726,95137,76411,76411,2282,0,0,0
95137,application_1511528684064_0054,1,90356,90356,95137,4781,4781,71,0,0,0
95147,application_1506638472019_6759,1,17129,17129,95147,78018,78018,2551,0,0,0
95147,application_1508364558011_34443,1,69778,69778,95147,25369,25369,519,0,0,0
95166,application_1508364558011_43582,1,77896,77896,95166,17270,17270,363,0,0,0
95189,application_1506638472019_6497,1,17073,17073,95189,78116,78116,2523,0,0,0
95189,application_1508364558011_8531,1,41643,41643,95189,53546,53546,1016,0,0,0
95199,application_1508364558011_3010,1,39131,39131,95199,56068,56068,1009,0,0,0
95199,application_1506638472019_7537,1,17227,17227,95199,77972,77972,2662,0,0,0
95206,application_1511528684064_0147,1,90796,90796,95206,4410,4410,67,0,0,0
95226,application_1506638472019_18442,1,24596,24596,95226,70630,70630,2023,0,0,0
95236,application_1508364558011_21513,1,50729,50729,95236,44507,44507,776,0,0,0
95236,application_1508364558011_39968,1,73788,73788,95236,21448,21448,367,0,0,0
95246,application_1506638472019_18565,1,24610,24610,95246,70636,70636,2001,0,0,0
95266,application_1508364558011_10476,1,42164,42164,95266,53102,53102,1161,0,0,0
95266,application_1506638472019_18950,1,24798,24798,95266,70468,70468,1847,0,0,0
95326,application_1508364558011_9541,1,42066,42066,95326,53260,53260,1309,0,0,0
95326,application_1511528684064_0597,1,93166,93166,95326,2160,2160,75,0,0,0
95326,application_1508364558011_11003,1,42907,42907,95326,52419,52419,1044,0,0,0
95346,application_1511528684064_0884,1,94196,94196,95346,1150,1150,53,0,0,0
95364,application_1511528684064_0275,1,91361,91361,95364,4003,4003,66,0,0,0
95384,application_1506638472019_22240,1,26532,26532,95384,68852,68852,1520,0,0,0
95384,application_1508364558011_3720,1,39259,39259,95384,56125,56125,1187,0,0,0
95394,application_1506638472019_18267,1,24567,24567,95394,70827,70827,2128,0,0,0
95394,application_1506638472019_8758,1,17534,17534,95394,77860,77860,2735,0,0,0
95394,application_1508364558011_39563,1,73752,73752,95394,21642,21642,508,0,0,0
95414,application_1506638472019_18745,1,24628,24628,95414,70786,70786,2118,0,0,0
95456,application_1508364558011_10541,1,42166,42166,95456,53290,53290,1331,0,0,0
95456,application_1508364558011_34269,1,69764,69764,95456,25692,25692,898,0,0,0
95466,application_1511528684064_0531,1,92765,92765,95466,2701,2701,55,0,0,0
95486,application_1506638472019_19777,1,24980,24980,95486,70506,70506,1794,0,0,0
95506,application_1508364558011_33331,1,69426,69426,95506,26080,26080,569,0,0,0
95516,application_1508364558011_44351,1,78149,78149,95516,17367,17367,306,0,0,0
95516,application_1511528684064_0945,1,94286,94286,95516,1230,1230,58,0,0,0
95539,application_1508364558011_39457,1,73652,73652,95539,21887,21887,1130,0,0,0
95549,application_1506638472019_18683,1,24622,24622,95549,70927,70927,2033,0,0,0
95563,application_1508364558011_44314,1,78143,78143,95563,17420,17420,240,0,0,0
95573,application_1506638472019_30082,1,30924,30924,95573,64649,64649,1966,0,0,0
95593,application_1508364558011_8138,1,41624,41624,95593,53969,53969,969,0,0,0
95593,application_1508364558011_21353,1,50724,50724,95593,44869,44869,1614,0,0,0
95603,application_1508364558011_2550,1,39023,39023,95603,56580,56580,1331,0,0,0
95613,application_1508364558011_4895,1,39810,39810,95613,55803,55803,1168,0,0,0
95623,application_1508364558011_5688,1,40038,40038,95623,55585,55585,1161,0,0,0
95623,application_1508364558011_10153,1,42146,42146,95623,53477,53477,1646,0,0,0
95648,application_1508364558011_39770,1,73769,73769,95648,21879,21879,312,0,0,0
95671,application_1508364558011_43682,1,77904,77904,95671,17767,17767,335,0,0,0
95673,application_1506638472019_11115,1,18676,18676,95673,76997,76997,2293,0,0,0
95693,application_1506638472019_19088,1,24824,24824,95693,70869,70869,1954,0,0,0
95693,application_1506638472019_19107,1,24826,24826,95693,70867,70867,1933,0,0,0
95713,application_1508364558011_51825,1,87728,87728,95713,7985,7985,170,0,0,0
95743,application_1508364558011_43903,1,77925,77925,95743,17818,17818,309,0,0,0
95743,application_1508364558011_43559,1,77894,77894,95743,17849,17849,332,0,0,0
95753,application_1508364558011_24826,1,57375,57375,95753,38378,38378,890,0,0,0
95763,application_1511528684064_0196,1,91036,91036,95763,4727,4727,73,0,0,0
95773,application_1511528684064_0065,1,90416,90416,95773,5357,5357,78,0,0,0
95773,application_1511528684064_0889,1,94206,94206,95773,1567,1567,60,0,0,0
95783,application_1508364558011_48154,1,83748,83748,95783,12035,12035,224,0,0,0
95783,application_1508364558011_39154,1,73625,73625,95783,22158,22158,517,0,0,0
95793,application_1511528684064_0514,1,92706,92706,95793,3087,3087,73,0,0,0
95826,application_1508364558011_19022,1,48253,48253,95826,47573,47573,1879,0,0,0
95826,application_1508364558011_51821,1,87728,87728,95826,8098,8098,175,0,0,0
95836,application_1508364558011_11651,1,43303,43303,95836,52533,52533,1059,0,0,0
95855,application_1506638472019_19951,1,25052,25052,95855,70803,70803,1876,0,0,0
95885,application_1506638472019_8092,1,17288,17288,95885,78597,78597,2763,0,0,0
95922,application_1508364558011_40417,1,73903,73903,95922,22019,22019,453,0,0,0
95932,application_1506638472019_18231,1,24546,24546,95932,71386,71386,2085,0,0,0
95942,application_1511528684064_1063,1,94711,94711,95942,1231,1231,29,0,0,0
95965,application_1506638472019_12125,1,18818,18818,95965,77147,77147,2578,0,0,0
95975,application_1508364558011_6643,1,40813,40813,95975,55162,55162,1197,0,0,0
96015,application_1508364558011_3811,1,39290,39290,96015,56725,56725,1503,0,0,0
96025,application_1511528684064_1072,1,94713,94713,96025,1312,1312,22,0,0,0
96035,application_1508364558011_44711,1,78177,78177,96035,17858,17858,339,0,0,0
96064,application_1506638472019_8007,1,17280,17280,96064,78784,78784,2646,0,0,0
96083,application_1506638472019_22265,1,26534,26534,96083,69549,69549,2358,0,0,0
96103,application_1508364558011_44143,1,78097,78097,96103,18006,18006,465,0,0,0
96117,application_1506638472019_6652,1,17092,17092,96117,79025,79025,2671,0,0,0
96127,application_1508364558011_40464,1,73906,73906,96127,22221,22221,315,0,0,0
96146,application_1508364558011_44332,1,78145,78145,96146,18001,18001,303,0,0,0
96166,application_1511528684064_0632,1,93396,93396,96166,2770,2770,62,0,0,0
96166,application_1511528684064_0565,1,92996,92996,96166,3170,3170,75,0,0,0
96190,application_1506638472019_30942,1,31040,31040,96190,65150,65150,1992,0,0,0
96200,application_1511528684064_0901,1,94227,94227,96200,1973,1973,55,0,0,0
96211,application_1508364558011_29778,1,66200,66200,96211,30011,30011,475,0,0,0
96220,application_1506638472019_5807,1,15909,15909,96220,80311,80311,2886,0,0,0
96239,application_1506638472019_17818,1,24492,24492,96239,71747,71747,2034,0,0,0
96240,application_1508364558011_24610,1,57287,57287,96240,38953,38953,792,0,0,0
96265,application_1508364558011_50317,2,86929,86929,96265,9336,9336,20,0,0,0
96275,application_1511528684064_0936,1,94266,94266,96275,2009,2009,57,0,0,0
96275,application_1506638472019_9154,1,17590,17590,96275,78685,78685,2757,0,0,0
96275,application_1508364558011_43648,1,77902,77902,96275,18373,18373,318,0,0,0
96275,application_1508364558011_20741,1,50009,50009,96275,46266,46266,1181,0,0,0
96275,application_1508364558011_44362,1,78150,78150,96275,18125,18125,287,0,0,0
96285,application_1506638472019_28710,1,29214,29214,96285,67071,67071,2460,0,0,0
96285,application_1511528684064_0527,1,92761,92761,96285,3524,3524,56,0,0,0
96306,application_1511528684064_1207,1,94947,94947,96306,1359,1359,33,0,0,0
96332,application_1508364558011_9389,1,42064,42064,96332,54268,54268,1554,0,0,0
96393,application_1511528684064_1190,1,94889,94889,96393,1504,1504,55,0,0,0
96393,application_1508364558011_2047,1,38858,38858,96393,57535,57535,1105,0,0,0
96403,application_1506638472019_7679,1,17244,17244,96403,79159,79159,2653,0,0,0
96415,application_1508364558011_10508,1,42165,42165,96415,54250,54250,1163,0,0,0
96447,application_1508364558011_39730,1,73766,73766,96447,22681,22681,407,0,0,0
96447,application_1508364558011_8985,1,41850,41850,96447,54597,54597,1177,0,0,0
96494,application_1508364558011_32635,1,68811,68811,96494,27683,27683,665,0,0,0
96504,application_1511528684064_0384,1,91996,91996,96504,4508,4508,71,0,0,0
96504,application_1511528684064_0584,1,93146,93146,96504,3358,3358,62,0,0,0
96524,application_1508364558011_14583,4,45166,45166,96524,51358,51358,175,0,0,0
96541,application_1506638472019_5595,1,15899,15899,96541,80642,80642,3115,0,0,0
96551,application_1506638472019_23723,1,27265,27265,96551,69286,69286,2594,0,0,0
96561,application_1506638472019_17910,1,24503,24503,96561,72058,72058,2064,0,0,0
96561,application_1508364558011_24767,1,57369,57369,96561,39192,39192,765,0,0,0
96571,application_1506638472019_5283,1,15822,15822,96571,80749,80749,2749,0,0,0
96581,application_1508364558011_3490,1,39238,39238,96581,57343,57343,1394,0,0,0
96607,application_1508364558011_23232,1,55848,55848,96607,40759,40759,888,0,0,0
96607,application_1511528684064_0363,1,91862,91862,96607,4745,4745,83,0,0,0
96647,application_1508364558011_8362,1,41627,41627,96647,55020,55020,1199,0,0,0
96647,application_1508364558011_48165,1,83749,83749,96647,12898,12898,200,0,0,0
96676,application_1508364558011_49231,1,85302,85302,96676,11374,11374,226,0,0,0
96686,application_1508364558011_2238,1,39002,39002,96686,57684,57684,1321,0,0,0
96696,application_1511528684064_0551,1,92906,92906,96696,3790,3790,68,0,0,0
96726,application_1506638472019_18266,1,24567,24567,96726,72159,72159,2139,0,0,0
96746,application_1508364558011_6760,1,40814,40814,96746,55932,55932,1151,0,0,0
96755,application_1506638472019_19245,1,24853,24853,96755,71902,71902,1856,0,0,0
96755,application_1511528684064_0662,1,93596,93596,96755,3159,3159,69,0,0,0
96755,application_1508364558011_33325,8,69425,69425,96755,27330,27330,157,0,0,0
96785,application_1508364558011_21435,1,50726,50726,96785,46059,46059,834,0,0,0
96785,application_1511528684064_1159,1,94863,94863,96785,1922,1922,29,0,0,0
96816,application_1508364558011_15302,1,45568,45568,96816,51248,51248,1234,0,0,0
96836,application_1508364558011_8334,1,41627,41627,96836,55209,55209,1132,0,0,0
96856,application_1508364558011_11743,1,43440,43440,96856,53416,53416,1274,0,0,0
96856,application_1508364558011_11090,1,42995,42995,96856,53861,53861,1004,0,0,0
96856,application_1506638472019_7423,1,17216,17216,96856,79640,79640,2580,0,0,0
96884,application_1508364558011_5044,1,39860,39860,96884,57024,57024,1745,0,0,0
96896,application_1508364558011_53122,1,90006,90006,96896,6890,6890,66,0,0,0
96896,application_1508364558011_11280,1,43059,43059,96896,53837,53837,1279,0,0,0
96901,application_1508364558011_43751,1,77912,77912,96901,18989,18989,382,0,0,0
96911,application_1506638472019_19821,1,24988,24988,96911,71923,71923,2097,0,0,0
96955,application_1508364558011_34231,1,69761,69761,96955,27194,27194,763,0,0,0
96996,application_1508364558011_49130,16,85168,85168,96996,11828,11828,273,0,0,0
96996,application_1508364558011_45009,1,78232,78232,96996,18764,18764,343,0,0,0
97046,application_1506638472019_10656,1,18628,18628,97046,78418,78418,2434,0,0,0
97056,application_1508364558011_34950,1,69869,69869,97056,27187,27187,512,0,0,0
97056,application_1506638472019_17005,1,23330,23330,97056,73726,73726,2803,0,0,0
97076,application_1506638472019_6352,1,17055,17055,97076,80021,80021,2489,0,0,0
97116,application_1508364558011_49214,1,85292,85292,97116,11824,11824,555,0,0,0
97166,application_1508364558011_33579,1,69526,69526,97166,27640,27640,862,0,0,0
97183,application_1508364558011_39778,1,73770,73770,97183,23413,23413,387,0,0,0
97206,application_1508364558011_49814,1,86346,86346,97206,10860,10860,209,0,0,0
97216,application_1508364558011_10558,1,42167,42167,97216,55049,55049,1209,0,0,0
97236,application_1506638472019_17849,1,24496,24496,97236,72740,72740,2137,0,0,0
97266,application_1508364558011_33540,1,69522,69522,97266,27744,27744,812,0,0,0
97286,application_1511528684064_1347,1,95206,95206,97286,2080,2080,72,0,0,0
97286,application_1506638472019_9087,1,17581,17581,97286,79705,79705,2702,0,0,0
97306,application_1506638472019_19557,1,24920,24920,97306,72386,72386,1868,0,0,0
97316,application_1506638472019_16909,1,23314,23314,97316,74002,74002,2730,0,0,0
97316,application_1508364558011_13498,1,44657,44657,97316,52659,52659,1144,0,0,0
97326,application_1511528684064_1197,1,94916,94916,97326,2410,2410,57,0,0,0
97346,application_1508364558011_45142,1,78245,78245,97346,19101,19101,307,0,0,0
97346,application_1511528684064_0646,1,93506,93506,97346,3840,3840,68,0,0,0
97357,application_1508364558011_14758,1,45315,45315,97357,52042,52042,1358,0,0,0
97389,application_1508364558011_39884,1,73779,73779,97389,23610,23610,499,0,0,0
97389,application_1506638472019_6392,1,17062,17062,97389,80327,80327,2688,0,0,0
97425,application_1508364558011_44242,1,78131,78131,97425,19294,19294,326,0,0,0
97485,application_1506638472019_37044,1,35535,35535,97485,61950,61950,1502,0,0,0
97503,application_1506638472019_8215,1,17303,17303,97503,80200,80200,2554,0,0,0
97521,application_1508364558011_8622,1,41645,41645,97521,55876,55876,1110,0,0,0
97531,application_1506638472019_28566,1,29193,29193,97531,68338,68338,2377,0,0,0
97531,application_1511528684064_0859,1,94126,94126,97531,3405,3405,75,0,0,0
97556,application_1506638472019_7595,1,17233,17233,97556,80323,80323,2636,0,0,0
97565,application_1506638472019_30178,1,30934,30934,97565,66631,66631,1930,0,0,0
97574,application_1508364558011_40328,1,73896,73896,97574,23678,23678,467,0,0,0
97574,application_1508364558011_36372,1,70634,70634,97574,26940,26940,402,0,0,0
97574,application_1511528684064_0908,1,94232,94232,97574,3342,3342,54,0,0,0
97578,application_1508364558011_5290,1,39868,39868,97578,57710,57710,1903,0,0,0
97588,application_1511528684064_2791,1,96466,96466,97588,1122,1122,63,0,0,0
97588,application_1506638472019_30440,1,30963,30963,97588,66625,66625,1938,0,0,0
97598,application_1508364558011_8275,1,41626,41626,97598,55972,55972,1169,0,0,0
97598,application_1508364558011_34954,1,69870,69870,97598,27728,27728,581,0,0,0
97619,application_1508364558011_29770,1,66197,66197,97619,31422,31422,500,0,0,0
97629,application_1511528684064_0755,1,93876,93876,97629,3753,3753,63,0,0,0
97629,application_1511528684064_1403,1,95336,95336,97629,2293,2293,64,0,0,0
97636,application_1508364558011_12244,1,43509,43509,97636,54127,54127,1223,0,0,0
97642,application_1506638472019_7591,1,17233,17233,97642,80409,80409,2650,0,0,0
97656,application_1506638472019_7787,1,17260,17260,97656,80396,80396,2571,0,0,0
97686,application_1506638472019_7573,1,17231,17231,97686,80455,80455,2598,0,0,0
97696,application_1506638472019_9186,1,17594,17594,97696,80102,80102,2596,0,0,0
97696,application_1511528684064_0598,1,93172,93172,97696,4524,4524,90,0,0,0
97706,application_1508364558011_44373,1,78151,78151,97706,19555,19555,462,0,0,0
97716,application_1508364558011_45064,1,78237,78237,97716,19479,19479,261,0,0,0
97722,application_1508364558011_10614,1,42169,42169,97722,55553,55553,1475,0,0,0
97737,application_1508364558011_2309,1,39004,39004,97737,58733,58733,1313,0,0,0
97747,application_1508364558011_12248,1,43510,43510,97747,54237,54237,1199,0,0,0
97747,application_1506638472019_22180,1,26525,26525,97747,71222,71222,1485,0,0,0
97767,application_1508364558011_43893,1,77925,77925,97767,19842,19842,432,0,0,0
97777,application_1506638472019_7751,1,17256,17256,97777,80521,80521,2560,0,0,0
97777,application_1508364558011_7423,1,41282,41282,97777,56495,56495,1262,0,0,0
97787,application_1506638472019_17914,1,24504,24504,97787,73283,73283,2023,0,0,0
97807,application_1506638472019_10740,1,18637,18637,97807,79170,79170,2411,0,0,0
97817,application_1511528684064_1386,1,95287,95287,97817,2530,2530,76,0,0,0
97817,application_1508364558011_14848,1,45369,45369,97817,52448,52448,1198,0,0,0
97817,application_1511528684064_0641,1,93456,93456,97817,4361,4361,57,0,0,0
97865,application_1511528684064_1960,1,96086,96086,97865,1779,1779,65,0,0,0
97875,application_1506638472019_18715,1,24625,24625,97875,73250,73250,2096,0,0,0
97880,application_1508364558011_5331,1,39870,39870,97880,58010,58010,1256,0,0,0
97880,application_1511528684064_1561,1,95796,95796,97880,2084,2084,61,0,0,0
97896,application_1508364558011_10536,1,42166,42166,97896,55730,55730,1352,0,0,0
97906,application_1508364558011_43490,1,77833,77833,97906,20073,20073,305,0,0,0
97926,application_1511528684064_2765,1,96405,96405,97926,1521,1521,36,0,0,0
97946,application_1506638472019_19571,1,24922,24922,97946,73024,73024,2104,0,0,0
97966,application_1508364558011_49817,1,86346,86346,97966,11620,11620,236,0,0,0
97976,application_1506638472019_11016,1,18666,18666,97976,79310,79310,2308,0,0,0
97989,application_1506638472019_19707,1,24966,24966,97989,73023,73023,1990,0,0,0
97999,application_1511528684064_2117,1,96106,96106,97999,1893,1893,58,0,0,0
98037,application_1506638472019_9089,1,17582,17582,98037,80455,80455,2588,0,0,0
98037,application_1511528684064_1175,1,94875,94875,98037,3162,3162,42,0,0,0
98047,application_1508364558011_16390,1,46506,46506,98047,51541,51541,1121,0,0,0
98069,application_1508364558011_8709,1,41646,41646,98069,56423,56423,1188,0,0,0
98069,application_1506638472019_18957,1,24799,24799,98069,73270,73270,1921,0,0,0
98079,application_1511528684064_0915,1,94236,94236,98079,3843,3843,66,0,0,0
98096,application_1511528684064_0616,1,93286,93286,98096,4810,4810,77,0,0,0
98116,application_1508364558011_48163,1,83749,83749,98116,14367,14367,214,0,0,0
98126,application_1506638472019_9176,1,17592,17592,98126,80534,80534,2798,0,0,0
98126,application_1508364558011_39086,1,73619,73619,98126,24507,24507,521,0,0,0
98126,application_1511528684064_1394,1,95306,95306,98126,2820,2820,65,0,0,0
98152,application_1508364558011_38883,1,73602,73602,98152,24550,24550,516,0,0,0
98162,application_1506638472019_16475,1,23151,23151,98162,75011,75011,2774,0,0,0
98175,application_1511528684064_0375,1,91946,91946,98175,6229,6229,73,0,0,0
98206,application_1508364558011_10970,1,42905,42905,98206,55301,55301,1009,0,0,0
98216,application_1506638472019_17103,1,23348,23348,98216,74868,74868,2784,0,0,0
98236,application_1506638472019_19415,1,24889,24889,98236,73347,73347,1894,0,0,0
98246,application_1508364558011_43629,1,77900,77900,98246,20346,20346,587,0,0,0
98281,application_1511528684064_1429,1,95426,95426,98281,2855,2855,73,0,0,0
98291,application_1508364558011_9437,1,42065,42065,98291,56226,56226,1100,0,0,0
98336,application_1511528684064_1055,1,94696,94696,98336,3640,3640,59,0,0,0
98336,application_1506638472019_19010,1,24810,24810,98336,73526,73526,1865,0,0,0
98356,application_1506638472019_6424,1,17065,17065,98356,81291,81291,2628,0,0,0
98356,application_1508364558011_49815,1,86346,86346,98356,12010,12010,188,0,0,0
98366,application_1506638472019_19589,1,24925,24925,98366,73441,73441,1840,0,0,0
98366,application_1506638472019_6412,1,17064,17064,98366,81302,81302,2545,0,0,0
98366,application_1508364558011_19391,1,48801,48801,98366,49565,49565,1483,0,0,0
98376,application_1508364558011_12575,1,43585,43585,98376,54791,54791,1414,0,0,0
98376,application_1508364558011_45530,1,78346,78346,98376,20030,20030,544,0,0,0
98376,application_1508364558011_51683,1,87543,87543,98376,10833,10833,292,0,0,0
98386,application_1508364558011_7808,1,41527,41527,98386,56859,56859,1203,0,0,0
98411,application_1508364558011_7338,1,41281,41281,98411,57130,57130,1217,0,0,0
98421,application_1508364558011_1686,1,38783,38783,98421,59638,59638,1233,0,0,0
98421,application_1508364558011_24411,1,56908,56908,98421,41513,41513,689,0,0,0
98426,application_1508364558011_34340,4,69770,69770,98426,28656,28656,325,0,0,0
98436,application_1506638472019_7122,1,17160,17160,98436,81276,81276,2546,0,0,0
98456,application_1508364558011_4916,1,39810,39810,98456,58646,58646,1333,0,0,0
98466,application_1508364558011_16124,1,46391,46391,98466,52075,52075,1205,0,0,0
98466,application_1508364558011_11678,1,43304,43304,98466,55162,55162,1171,0,0,0
98466,application_1511528684064_1612,1,95886,95886,98466,2580,2580,72,0,0,0
98476,application_1508364558011_37679,1,72323,72323,98476,26153,26153,511,0,0,0
98496,application_1511916184019_0317,1,96996,96996,98496,1500,1500,56,0,0,0
98506,application_1508364558011_49096,4,85126,85126,98506,13380,13380,94,0,0,0
98516,application_1508364558011_14457,1,45028,45028,98516,53488,53488,1136,0,0,0
98526,application_1508364558011_39864,1,73777,73777,98526,24749,24749,597,0,0,0
98536,application_1506638472019_19073,1,24821,24821,98536,73715,73715,1959,0,0,0
98546,application_1511528684064_1397,1,95316,95316,98546,3230,3230,69,0,0,0
98556,application_1511528684064_1104,1,94756,94756,98556,3800,3800,60,0,0,0
98556,application_1506638472019_30536,1,30994,30994,98556,67562,67562,2038,0,0,0
98556,application_1508364558011_44152,1,78098,78098,98556,20458,20458,454,0,0,0
98616,application_1506638472019_16243,1,23104,23104,98616,75512,75512,2817,0,0,0
98616,application_1506638472019_9026,1,17572,17572,98616,81044,81044,2699,0,0,0
98626,application_1506638472019_5567,1,15898,15898,98626,82728,82728,3142,0,0,0
98626,application_1508364558011_11629,1,43302,43302,98626,55324,55324,1226,0,0,0
98646,application_1508364558011_10524,1,42166,42166,98646,56480,56480,1276,0,0,0
98646,application_1508364558011_39320,1,73640,73640,98646,25006,25006,609,0,0,0
98646,application_1511528684064_1471,1,95553,95553,98646,3093,3093,73,0,0,0
98646,application_1511916184019_0714,1,98027,98027,98646,619,619,26,0,0,0
98696,application_1508364558011_7184,1,41278,41278,98696,57418,57418,1403,0,0,0
98706,application_1508364558011_39857,1,73777,73777,98706,24929,24929,592,0,0,0
98716,application_1508364558011_39682,1,73762,73762,98716,24954,24954,518,0,0,0
98736,application_1508364558011_9460,1,42065,42065,98736,56671,56671,1101,0,0,0
98755,application_1508364558011_7227,1,41279,41279,98755,57476,57476,1337,0,0,0
98765,application_1508364558011_39550,1,73751,73751,98765,25014,25014,524,0,0,0
98775,application_1508364558011_39554,1,73751,73751,98775,25024,25024,615,0,0,0
98775,application_1508364558011_24987,1,57400,57400,98775,41375,41375,726,0,0,0
98775,application_1508364558011_11135,1,42997,42997,98775,55778,55778,1304,0,0,0
98775,application_1506638472019_37082,1,35537,35537,98775,63238,63238,1492,0,0,0
98815,application_1506638472019_16732,1,23280,23280,98815,75535,75535,2719,0,0,0
98842,application_1508364558011_23203,1,55846,55846,98842,42996,42996,890,0,0,0
98862,application_1506638472019_3470,1,13433,13433,98862,85429,85429,3648,0,0,0
98862,application_1508364558011_48223,1,83969,83969,98862,14893,14893,229,0,0,0
98878,application_1508364558011_4903,1,39810,39810,98878,59068,59068,1575,0,0,0
98878,application_1506638472019_19738,1,24973,24973,98878,73905,73905,1876,0,0,0
98878,application_1508364558011_24630,1,57289,57289,98878,41589,41589,921,0,0,0
98916,application_1508364558011_8645,1,41645,41645,98916,57271,57271,1187,0,0,0
98926,application_1511528684064_1323,1,95166,95166,98926,3760,3760,69,0,0,0
98926,application_1508364558011_9401,1,42064,42064,98926,56862,56862,1503,0,0,0
98936,application_1508364558011_44959,1,78229,78229,98936,20707,20707,465,0,0,0
98936,application_1508364558011_14823,1,45367,45367,98936,53569,53569,1686,0,0,0
98936,application_1508364558011_21498,1,50729,50729,98936,48207,48207,1078,0,0,0
98947,application_1508364558011_11025,1,42908,42908,98947,56039,56039,1283,0,0,0
98976,application_1508364558011_5590,1,40037,40037,98976,58939,58939,2068,0,0,0
98996,application_1506638472019_7337,1,17175,17175,98996,81821,81821,2446,0,0,0
99016,application_1506638472019_19663,1,24937,24937,99016,74079,74079,1878,0,0,0
99016,application_1508364558011_38898,1,73604,73604,99016,25412,25412,595,0,0,0
99060,application_1511916184019_0598,1,97835,97835,99060,1225,1225,36,0,0,0
99070,application_1508364558011_45336,1,78263,78263,99070,20807,20807,484,0,0,0
99084,application_1506638472019_6963,1,17150,17150,99084,81934,81934,2575,0,0,0
99096,application_1508364558011_5726,1,40039,40039,99096,59057,59057,1298,0,0,0
99106,application_1508364558011_9983,1,42140,42140,99106,56966,56966,1093,0,0,0
99106,application_1508364558011_4445,4,39373,39373,99106,59733,59733,679,0,0,0
99116,application_1508364558011_39769,1,73769,73769,99116,25347,25347,902,0,0,0
99140,application_1506638472019_18693,1,24623,24623,99140,74517,74517,2104,0,0,0
99140,application_1508364558011_9523,1,42066,42066,99140,57074,57074,1262,0,0,0
99140,application_1508364558011_45091,1,78239,78239,99140,20901,20901,340,0,0,0
99170,application_1506638472019_5603,1,15899,15899,99170,83271,83271,2758,0,0,0
99191,application_1506638472019_30839,1,31030,31030,99191,68161,68161,1960,0,0,0
99191,application_1506638472019_11029,1,18667,18667,99191,80524,80524,2572,0,0,0
99196,application_1506638472019_12451,1,18964,18964,99196,80232,80232,2364,0,0,0
99207,application_1511916184019_0236,1,96876,96876,99207,2331,2331,72,0,0,0
99207,application_1508364558011_10602,1,42169,42169,99207,57038,57038,1118,0,0,0
99227,application_1508364558011_4363,1,39365,39365,99227,59862,59862,1410,0,0,0
99227,application_1508364558011_5714,1,40039,40039,99227,59188,59188,1129,0,0,0
99237,application_1506638472019_8190,1,17300,17300,99237,81937,81937,2599,0,0,0
99316,application_1508364558011_10465,1,42163,42163,99316,57153,57153,1170,0,0,0
99316,application_1508364558011_10403,1,42150,42150,99316,57166,57166,1244,0,0,0
99316,application_1506638472019_8143,1,17292,17292,99316,82024,82024,2560,0,0,0
99346,application_1508364558011_1873,1,38852,38852,99346,60494,60494,1400,0,0,0
99356,application_1506638472019_6950,1,17150,17150,99356,82206,82206,2451,0,0,0
99376,application_1508364558011_39557,1,73751,73751,99376,25625,25625,601,0,0,0
99393,application_1506638472019_7319,1,17174,17174,99393,82219,82219,2514,0,0,0
99403,application_1508364558011_20731,1,50007,50007,99403,49396,49396,1105,0,0,0
99423,application_1506638472019_18991,1,24805,24805,99423,74618,74618,1917,0,0,0
99423,application_1508364558011_6519,1,40811,40811,99423,58612,58612,1503,0,0,0
99454,application_1508364558011_44994,1,78231,78231,99454,21223,21223,383,0,0,0
99454,application_1508364558011_29234,1,65459,65459,99454,33995,33995,794,0,0,0
99454,application_1506638472019_8044,1,17284,17284,99454,82170,82170,2659,0,0,0
99464,application_1506638472019_8178,1,17297,17297,99464,82167,82167,2667,0,0,0
99464,application_1506638472019_19580,1,24923,24923,99464,74541,74541,2069,0,0,0
99503,application_1511916184019_0543,1,97727,97727,99503,1776,1776,36,0,0,0
99513,application_1511528684064_2521,1,96300,96300,99513,3213,3213,69,0,0,0
99513,application_1506638472019_8885,1,17552,17552,99513,81961,81961,2749,0,0,0
99533,application_1508364558011_37502,1,72308,72308,99533,27225,27225,511,0,0,0
99543,application_1511916184019_0136,1,96666,96666,99543,2877,2877,75,0,0,0
99616,application_1508364558011_10342,1,42149,42149,99616,57467,57467,1243,0,0,0
99616,application_1511528684064_1648,1,95976,95976,99616,3640,3640,65,0,0,0
99636,application_1508364558011_5825,1,40042,40042,99636,59594,59594,1495,0,0,0
99636,application_1506638472019_7730,1,17251,17251,99636,82385,82385,2648,0,0,0
99646,application_1508364558011_45256,1,78255,78255,99646,21391,21391,454,0,0,0
99656,application_1506638472019_19586,1,24924,24924,99656,74732,74732,1836,0,0,0
99666,application_1508364558011_15259,1,45568,45568,99666,54098,54098,1131,0,0,0
99676,application_1508364558011_13465,1,44637,44637,99676,55039,55039,1160,0,0,0
99702,application_1508364558011_7267,1,41280,41280,99702,58422,58422,1339,0,0,0
99712,application_1511528684064_0801,1,93996,93996,99712,5716,5716,68,0,0,0
99712,application_1506638472019_18325,1,24573,24573,99712,75139,75139,2127,0,0,0
99728,application_1511528684064_1226,1,94974,94974,99728,4754,4754,215,0,0,0
99728,application_1508364558011_47022,1,80096,80096,99728,19632,19632,466,0,0,0
99738,application_1506638472019_18420,1,24594,24594,99738,75144,75144,2088,0,0,0
99748,application_1508364558011_44113,1,78094,78094,99748,21654,21654,470,0,0,0
99765,application_1508364558011_44418,1,78154,78154,99765,21611,21611,454,0,0,0
99765,application_1506638472019_18455,1,24597,24597,99765,75168,75168,2061,0,0,0
99787,application_1506638472019_18214,1,24544,24544,99787,75243,75243,2065,0,0,0
99787,application_1506638472019_18003,1,24513,24513,99787,75274,75274,2055,0,0,0
99787,application_1508364558011_39886,1,73779,73779,99787,26008,26008,582,0,0,0
99807,application_1511916184019_0792,1,98165,98165,99807,1642,1642,55,0,0,0
99807,application_1508364558011_25273,1,57446,57446,99807,42361,42361,813,0,0,0
99817,application_1506638472019_6673,1,17095,17095,99817,82722,82722,2473,0,0,0
99873,application_1506638472019_7187,1,17163,17163,99873,82710,82710,2469,0,0,0
99873,application_1508364558011_5733,1,40039,40039,99873,59834,59834,1192,0,0,0
99873,application_1506638472019_17871,1,24499,24499,99873,75374,75374,2058,0,0,0
99883,application_1508364558011_49818,1,86346,86346,99883,13537,13537,242,0,0,0
99883,application_1508364558011_12401,1,43574,43574,99883,56309,56309,1296,0,0,0
99883,application_1511916184019_0167,1,96756,96756,99883,3127,3127,79,0,0,0
99883,application_1508364558011_29409,8,65945,65945,99883,33938,33938,64,0,0,0
99903,application_1508364558011_4224,1,39362,39362,99903,60541,60541,1249,0,0,0
99903,application_1511916184019_0345,1,97086,97086,99903,2817,2817,68,0,0,0
99913,application_1508364558011_3884,1,39295,39295,99913,60618,60618,1251,0,0,0
99913,application_1511916184019_0161,1,96746,96746,99913,3167,3167,67,0,0,0
99913,application_1511916184019_1280,1,99243,99243,99913,670,670,14,0,0,0
99913,application_1511916184019_1266,1,99242,99242,99913,671,671,13,0,0,0
99923,application_1506638472019_5367,1,15891,15891,99923,84032,84032,3061,0,0,0
99933,application_1506638472019_2622,1,13294,13294,99933,86639,86639,3686,0,0,0
99933,application_1508364558011_33482,8,69492,69492,99933,30441,30441,209,0,0,0
99956,application_1508364558011_23222,1,55847,55847,99956,44109,44109,1069,0,0,0
99956,application_1506638472019_6376,1,17058,17058,99956,82898,82898,2644,0,0,0
99956,application_1508364558011_4982,1,39859,39859,99956,60097,60097,1591,0,0,0
99986,application_1506638472019_17817,1,24492,24492,99986,75494,75494,2068,0,0,0
100006,application_1508364558011_21419,1,50726,50726,100006,49280,49280,994,0,0,0
100026,application_1508364558011_8136,1,41624,41624,100026,58402,58402,1512,0,0,0
100026,application_1506638472019_8910,1,17556,17556,100026,82470,82470,2695,0,0,0
100076,application_1506638472019_18517,1,24604,24604,100076,75472,75472,2161,0,0,0
100096,application_1506638472019_7243,1,17167,17167,100096,82929,82929,2482,0,0,0
100106,application_1506638472019_19504,1,24911,24911,100106,75195,75195,1964,0,0,0
100116,application_1511528684064_2750,1,96376,96376,100116,3740,3740,75,0,0,0
100126,application_1508364558011_16129,1,46391,46391,100126,53735,53735,1280,0,0,0
100126,application_1511916184019_1270,1,99242,99242,100126,884,884,11,0,0,0
100136,application_1506638472019_17155,1,23359,23359,100136,76777,76777,2802,0,0,0
100136,application_1511916184019_1060,1,98706,98706,100136,1430,1430,68,0,0,0
100156,application_1508364558011_16327,1,46502,46502,100156,53654,53654,1219,0,0,0
100166,application_1508364558011_8999,1,41851,41851,100166,58315,58315,1518,0,0,0
100186,application_1506638472019_5229,1,15820,15820,100186,84366,84366,2969,0,0,0
100196,application_1508364558011_37575,1,72315,72315,100196,27881,27881,508,0,0,0
100196,application_1506638472019_7650,1,17240,17240,100196,82956,82956,2585,0,0,0
100206,application_1511916184019_0443,1,97546,97546,100206,2660,2660,71,0,0,0
100216,application_1508364558011_8580,1,41644,41644,100216,58572,58572,1235,0,0,0
100226,application_1508364558011_9430,1,42064,42064,100226,58162,58162,1369,0,0,0
100236,application_1508364558011_49380,1,85532,85532,100236,14704,14704,280,0,0,0
100246,application_1511916184019_0501,1,97646,97646,100246,2600,2600,58,0,0,0
100256,application_1508364558011_49125,1,85167,85167,100256,15089,15089,215,0,0,0
100256,application_1508364558011_21454,1,50727,50727,100256,49529,49529,1117,0,0,0
100266,application_1508364558011_1664,1,38781,38781,100266,61485,61485,2056,0,0,0
100276,application_1506638472019_8199,1,17301,17301,100276,82975,82975,2637,0,0,0
100306,application_1508364558011_14816,1,45367,45367,100306,54939,54939,1571,0,0,0
100306,application_1508364558011_8337,1,41627,41627,100306,58679,58679,1264,0,0,0
100306,application_1508364558011_12172,1,43506,43506,100306,56800,56800,1089,0,0,0
100318,application_1511916184019_0177,1,96776,96776,100318,3542,3542,63,0,0,0
100328,application_1506638472019_7931,1,17271,17271,100328,83057,83057,2576,0,0,0
100328,application_1508364558011_36386,8,70653,70653,100328,29675,29675,494,0,0,0
100338,application_1506638472019_17997,1,24513,24513,100338,75825,75825,2144,0,0,0
100348,application_1508364558011_45502,1,78341,78341,100348,22007,22007,467,0,0,0
100348,application_1506638472019_7384,1,17211,17211,100348,83137,83137,2557,0,0,0
100376,application_1506638472019_18719,1,24625,24625,100376,75751,75751,2031,0,0,0
100386,application_1511916184019_0536,1,97722,97722,100386,2664,2664,30,0,0,0
100386,application_1506638472019_5731,1,15904,15904,100386,84482,84482,3127,0,0,0
100386,application_1508364558011_21688,4,50969,50969,100386,49417,49417,641,0,0,0
100416,application_1508364558011_12238,1,43509,43509,100416,56907,56907,1183,0,0,0
100430,application_1508364558011_48681,1,84657,84657,100430,15773,15773,265,0,0,0
100440,application_1511916184019_0374,1,97236,97236,100440,3204,3204,66,0,0,0
100456,application_1508364558011_8652,1,41645,41645,100456,58811,58811,1201,0,0,0
100484,application_1506638472019_19129,1,24832,24832,100484,75652,75652,1899,0,0,0
100484,application_1508364558011_34010,1,69721,69721,100484,30763,30763,589,0,0,0
100484,application_1511916184019_0310,1,96976,96976,100484,3508,3508,60,0,0,0
100494,application_1511916184019_1036,1,98646,98646,100494,1848,1848,72,0,0,0
100504,application_1506638472019_7779,1,17259,17259,100504,83245,83245,2625,0,0,0
100504,application_1508364558011_15147,1,45566,45566,100504,54938,54938,944,0,0,0
100504,application_1508364558011_44312,1,78143,78143,100504,22361,22361,379,0,0,0
100508,application_1508364558011_4740,1,39805,39805,100508,60703,60703,1506,0,0,0
100508,application_1506638472019_11694,1,18771,18771,100508,81737,81737,2322,0,0,0
100515,application_1508364558011_8669,1,41646,41646,100515,58869,58869,1812,0,0,0
100535,application_1508364558011_39877,1,73778,73778,100535,26757,26757,316,0,0,0
100535,application_1506638472019_18167,1,24539,24539,100535,75996,75996,2086,0,0,0
100545,application_1508364558011_36139,1,70426,70426,100545,30119,30119,498,0,0,0
100555,application_1508364558011_48146,8,83730,83730,100555,16825,16825,133,0,0,0
100565,application_1511916184019_1882,1,100056,100056,100565,509,509,60,0,0,0
100565,application_1506638472019_17405,1,23782,23782,100565,76783,76783,2083,0,0,0
100615,application_1506638472019_9035,1,17573,17573,100615,83042,83042,2742,0,0,0
100645,application_1511916184019_0765,1,98086,98086,100645,2559,2559,66,0,0,0
100685,application_1506638472019_19730,1,24971,24971,100685,75714,75714,1894,0,0,0
100691,application_1508364558011_5548,1,40036,40036,100691,60655,60655,1357,0,0,0
100691,application_1508364558011_45177,1,78248,78248,100691,22443,22443,459,0,0,0
100701,application_1508364558011_18802,1,48068,48068,100701,52633,52633,1062,0,0,0
100701,application_1508364558011_14504,1,45102,45102,100701,55599,55599,1171,0,0,0
100720,application_1508364558011_14156,1,44910,44910,100720,55810,55810,1176,0,0,0
100741,application_1508364558011_44488,1,78160,78160,100741,22581,22581,456,0,0,0
100751,application_1506638472019_30678,1,31010,31010,100751,69741,69741,2021,0,0,0
100764,application_1508364558011_39378,1,73645,73645,100764,27119,27119,591,0,0,0
100774,application_1508364558011_37259,1,72288,72288,100774,28486,28486,754,0,0,0
100784,application_1508364558011_37407,1,72301,72301,100784,28483,28483,601,0,0,0
100793,application_1508364558011_5886,1,40043,40043,100793,60750,60750,1426,0,0,0
100796,application_1508364558011_37708,1,72325,72325,100796,28471,28471,594,0,0,0
100806,application_1508364558011_14840,1,45368,45368,100806,55438,55438,1238,0,0,0
100816,application_1508364558011_38869,1,73601,73601,100816,27215,27215,597,0,0,0
100826,application_1511916184019_1071,1,98755,98755,100826,2071,2071,72,0,0,0
100826,application_1508364558011_44096,1,78092,78092,100826,22734,22734,449,0,0,0
100845,application_1508364558011_42355,1,76251,76251,100845,24594,24594,964,0,0,0
100859,application_1506638472019_7934,1,17271,17271,100859,83588,83588,2527,0,0,0
100869,application_1506638472019_11031,1,18667,18667,100869,82202,82202,2423,0,0,0
100886,application_1508364558011_16109,1,46390,46390,100886,54496,54496,1175,0,0,0
100886,application_1508364558011_12240,1,43509,43509,100886,57377,57377,1172,0,0,0
100896,application_1506638472019_6370,1,17057,17057,100896,83839,83839,2610,0,0,0
100906,application_1511916184019_0871,1,98306,98306,100906,2600,2600,66,0,0,0
100906,application_1506638472019_7448,1,17219,17219,100906,83687,83687,2454,0,0,0
100946,application_1508364558011_16406,1,46507,46507,100946,54439,54439,1497,0,0,0
100946,application_1508364558011_37527,1,72311,72311,100946,28635,28635,525,0,0,0
100946,application_1511916184019_0948,1,98426,98426,100946,2520,2520,63,0,0,0
100966,application_1506638472019_4825,1,15800,15800,100966,85166,85166,3160,0,0,0
100966,application_1506638472019_18405,1,24592,24592,100966,76374,76374,2206,0,0,0
100976,application_1506638472019_6397,1,17062,17062,100976,83914,83914,2545,0,0,0
100976,application_1508364558011_39361,1,73643,73643,100976,27333,27333,597,0,0,0
100976,application_1506638472019_8153,1,17293,17293,100976,83683,83683,2694,0,0,0
100986,application_1506638472019_6917,1,17148,17148,100986,83838,83838,2445,0,0,0
101006,application_1511916184019_0199,1,96796,96796,101006,4210,4210,71,0,0,0
101026,application_1511916184019_0826,1,98236,98236,101026,2790,2790,82,0,0,0
101086,application_1506638472019_7572,1,17231,17231,101086,83855,83855,2570,0,0,0
101086,application_1511916184019_0441,1,97536,97536,101086,3550,3550,55,0,0,0
101106,application_1508364558011_10583,1,42168,42168,101106,58938,58938,1077,0,0,0
101116,application_1511916184019_1028,1,98616,98616,101116,2500,2500,59,0,0,0
101170,application_1511916184019_0988,1,98496,98496,101170,2674,2674,73,0,0,0
101180,application_1511916184019_0494,1,97636,97636,101180,3544,3544,69,0,0,0
101190,application_1508364558011_20797,1,50146,50146,101190,51044,51044,1088,0,0,0
101213,application_1508364558011_5205,1,39864,39864,101213,61349,61349,1434,0,0,0
101246,application_1508364558011_37467,1,72306,72306,101246,28940,28940,506,0,0,0
101266,application_1508364558011_44720,1,78178,78178,101266,23088,23088,459,0,0,0
101266,application_1508364558011_40037,1,73794,73794,101266,27472,27472,571,0,0,0
101276,application_1508364558011_33811,1,69690,69690,101276,31586,31586,916,0,0,0
101276,application_1506638472019_6485,1,17071,17071,101276,84205,84205,2642,0,0,0
101332,application_1511916184019_0777,1,98116,98116,101332,3216,3216,63,0,0,0
101353,application_1506638472019_9086,1,17581,17581,101353,83772,83772,2714,0,0,0
101353,application_1511916184019_0186,1,96777,96777,101353,4576,4576,150,0,0,0
101363,application_1506638472019_7969,1,17275,17275,101363,84088,84088,2643,0,0,0
101386,application_1508364558011_9486,1,42065,42065,101386,59321,59321,1057,0,0,0
101396,application_1508364558011_6785,1,40815,40815,101396,60581,60581,1347,0,0,0
101396,application_1508364558011_20975,1,50266,50266,101396,51130,51130,1572,0,0,0
101406,application_1508364558011_37512,1,72309,72309,101406,29097,29097,508,0,0,0
101419,application_1506638472019_18921,1,24792,24792,101419,76627,76627,1918,0,0,0
101419,application_1506638472019_30792,1,31025,31025,101419,70394,70394,1942,0,0,0
101419,application_1506638472019_6348,1,17054,17054,101419,84365,84365,2476,0,0,0
101419,application_1508364558011_39530,1,73749,73749,101419,27670,27670,511,0,0,0
101439,application_1508364558011_12542,1,43584,43584,101439,57855,57855,1440,0,0,0
101456,application_1511916184019_0712,1,98027,98027,101456,3429,3429,65,0,0,0
101476,application_1506638472019_18058,1,24518,24518,101476,76958,76958,2162,0,0,0
101476,application_1508364558011_1907,1,38853,38853,101476,62623,62623,1322,0,0,0
101486,application_1511916184019_0369,1,97206,97206,101486,4280,4280,73,0,0,0
101486,application_1511916184019_0623,1,97886,97886,101486,3600,3600,73,0,0,0
101506,application_1508364558011_9599,1,42067,42067,101506,59439,59439,1298,0,0,0
101516,application_1508364558011_47526,1,80679,80679,101516,20837,20837,359,0,0,0
101566,application_1508364558011_43650,1,77902,77902,101566,23664,23664,501,0,0,0
101586,application_1511916184019_2153,1,100817,100817,101586,769,769,27,0,0,0
101586,application_1506638472019_18172,1,24540,24540,101586,77046,77046,2128,0,0,0
101586,application_1506638472019_28942,1,29313,29313,101586,72273,72273,2367,0,0,0
101596,application_1508364558011_11680,1,43304,43304,101596,58292,58292,1274,0,0,0
101606,application_1508364558011_9100,1,41852,41852,101606,59754,59754,1258,0,0,0
101616,application_1511916184019_0806,1,98196,98196,101616,3420,3420,60,0,0,0
101716,application_1508364558011_14138,1,44891,44891,101716,56825,56825,1135,0,0,0
101726,application_1506638472019_8208,1,17302,17302,101726,84424,84424,2594,0,0,0
101726,application_1508364558011_39339,1,73641,73641,101726,28085,28085,512,0,0,0
101746,application_1508364558011_49881,1,86381,86381,101746,15365,15365,650,0,0,0
101764,application_1508364558011_18794,1,48067,48067,101764,53697,53697,1447,0,0,0
101773,application_1506638472019_5795,1,15908,15908,101773,85865,85865,3073,0,0,0
101783,application_1506638472019_7682,1,17245,17245,101783,84538,84538,2764,0,0,0
101793,application_1511916184019_1909,1,100156,100156,101793,1637,1637,73,0,0,0
101873,application_1508364558011_11189,1,43013,43013,101873,58860,58860,1292,0,0,0
101883,application_1506638472019_6326,1,17050,17050,101883,84833,84833,2466,0,0,0
101893,application_1508364558011_44192,1,78104,78104,101893,23789,23789,488,0,0,0
101913,application_1508364558011_19703,1,49114,49114,101913,52799,52799,1497,0,0,0
101923,application_1506638472019_27864,1,29052,29052,101923,72871,72871,2393,0,0,0
101936,application_1508364558011_40009,1,73791,73791,101936,28145,28145,823,0,0,0
101966,application_1508364558011_44299,1,78142,78142,101966,23824,23824,496,0,0,0
101966,application_1508364558011_2472,1,39015,39015,101966,62951,62951,1588,0,0,0
101976,application_1506638472019_18022,1,24515,24515,101976,77461,77461,2174,0,0,0
101976,application_1506638472019_18641,1,24618,24618,101976,77358,77358,2198,0,0,0
102006,application_1508364558011_15843,1,46167,46167,102006,55839,55839,1284,0,0,0
102016,application_1506638472019_17889,1,24501,24501,102016,77515,77515,2163,0,0,0
102046,application_1508364558011_19699,1,49114,49114,102046,52932,52932,1439,0,0,0
102065,application_1506638472019_30478,1,30967,30967,102065,71098,71098,2033,0,0,0
102085,application_1506638472019_30930,1,31039,31039,102085,71046,71046,2032,0,0,0
102095,application_1508364558011_22326,1,53501,53501,102095,48594,48594,1482,0,0,0
102112,application_1506638472019_8866,1,17549,17549,102112,84563,84563,2782,0,0,0
102145,application_1506638472019_27946,1,29066,29066,102145,73079,73079,2357,0,0,0
102155,application_1508364558011_33617,1,69530,69530,102155,32625,32625,823,0,0,0
102190,application_1511916184019_2135,1,100793,100793,102190,1397,1397,45,0,0,0
102200,application_1506638472019_8245,1,17307,17307,102200,84893,84893,2630,0,0,0
102220,application_1511916184019_1131,1,98936,98936,102220,3284,3284,69,0,0,0
102220,application_1508364558011_6520,1,40811,40811,102220,61409,61409,1492,0,0,0
102220,application_1511916184019_1186,1,99046,99046,102220,3174,3174,72,0,0,0
102220,application_1506638472019_5403,1,15893,15893,102220,86327,86327,2943,0,0,0
102220,application_1508364558011_13854,1,44699,44699,102220,57521,57521,1322,0,0,0
102230,application_1508364558011_44161,1,78099,78099,102230,24131,24131,536,0,0,0
102247,application_1506638472019_6784,1,17132,17132,102247,85115,85115,2646,0,0,0
102257,application_1508364558011_24678,1,57336,57336,102257,44921,44921,1604,0,0,0
102257,application_1508364558011_6462,1,40810,40810,102257,61447,61447,1992,0,0,0
102267,application_1506638472019_18160,1,24539,24539,102267,77728,77728,2058,0,0,0
102267,application_1506638472019_7803,1,17261,17261,102267,85006,85006,2636,0,0,0
102286,application_1506638472019_30731,1,31018,31018,102286,71268,71268,2010,0,0,0
102308,application_1506638472019_21720,1,26320,26320,102308,75988,75988,2353,0,0,0
102308,application_1508364558011_30050,8,66248,66248,102308,36060,36060,77,0,0,0
102346,application_1508364558011_37038,1,72027,72027,102346,30319,30319,795,0,0,0
102376,application_1508364558011_17343,1,47415,47415,102376,54961,54961,1260,0,0,0
102376,application_1508364558011_21483,1,50728,50728,102376,51648,51648,1314,0,0,0
102416,application_1508364558011_6694,1,40814,40814,102416,61602,61602,1538,0,0,0
102416,application_1508364558011_1765,1,38834,38834,102416,63582,63582,1452,0,0,0
102416,application_1506638472019_7655,1,17241,17241,102416,85175,85175,2571,0,0,0
102426,application_1511916184019_1479,1,99565,99565,102426,2861,2861,300,0,0,0
102426,application_1508364558011_9627,1,42067,42067,102426,60359,60359,1359,0,0,0
102446,application_1511916184019_1466,1,99563,99563,102446,2883,2883,318,0,0,0
102456,application_1506638472019_9098,1,17583,17583,102456,84873,84873,2728,0,0,0
102476,application_1508364558011_20759,1,50010,50010,102476,52466,52466,1422,0,0,0
102486,application_1506638472019_21779,1,26327,26327,102486,76159,76159,2441,0,0,0
102546,application_1511916184019_2394,1,101332,101332,102546,1214,1214,317,0,0,0
102549,application_1508364558011_8115,1,41624,41624,102549,60925,60925,1875,0,0,0
102596,application_1508364558011_2462,1,39015,39015,102596,63581,63581,1649,0,0,0
102666,application_1506638472019_24467,1,27674,27674,102666,74992,74992,2641,0,0,0
102716,application_1508364558011_43997,1,77934,77934,102716,24782,24782,943,0,0,0
102736,application_1508364558011_21429,1,50726,50726,102736,52010,52010,1490,0,0,0
102756,application_1506638472019_27929,1,29061,29061,102756,73695,73695,2296,0,0,0
102768,application_1508364558011_4307,1,39364,39364,102768,63404,63404,2082,0,0,0
102786,application_1506638472019_26568,1,28552,28552,102786,74234,74234,3366,0,0,0
102796,application_1508364558011_11298,1,43060,43060,102796,59736,59736,1702,0,0,0
102866,application_1508364558011_7131,1,41278,41278,102866,61588,61588,2046,0,0,0
102906,application_1508364558011_43985,1,77933,77933,102906,24973,24973,999,0,0,0
102906,application_1508364558011_8065,1,41623,41623,102906,61283,61283,1786,0,0,0
102906,application_1508364558011_47582,8,80839,80839,102906,22067,22067,160,0,0,0
102936,application_1506638472019_28434,1,29159,29159,102936,73777,73777,2285,0,0,0
102966,application_1506638472019_28759,1,29221,29221,102966,73745,73745,2403,0,0,0
102976,application_1506638472019_17060,1,23341,23341,102976,79635,79635,2777,0,0,0
102976,application_1508364558011_30230,8,66501,66501,102976,36475,36475,186,0,0,0
102996,application_1506638472019_16210,1,23098,23098,102996,79898,79898,2864,0,0,0
103046,application_1506638472019_27872,1,29053,29053,103046,73993,73993,2450,0,0,0
103056,application_1506638472019_7717,1,17249,17249,103056,85807,85807,3827,0,0,0
103066,application_1508364558011_6832,1,40816,40816,103066,62250,62250,1998,0,0,0
103096,application_1508364558011_8842,1,41848,41848,103096,61248,61248,2041,0,0,0
103216,application_1508364558011_8445,1,41642,41642,103216,61574,61574,2256,0,0,0
103236,application_1508364558011_9882,1,42139,42139,103236,61097,61097,1305,0,0,0
103316,application_1506638472019_5222,1,15820,15820,103316,87496,87496,4092,0,0,0
103316,application_1508364558011_5282,1,39868,39868,103316,63448,63448,2371,0,0,0
103346,application_1508364558011_35068,1,69883,69883,103346,33463,33463,1892,0,0,0
103376,application_1508364558011_3567,1,39248,39248,103376,64128,64128,2631,0,0,0
103386,application_1506638472019_5157,1,15817,15817,103386,87569,87569,4096,0,0,0
103476,application_1506638472019_30144,1,30931,30931,103476,72545,72545,2028,0,0,0
103506,application_1508364558011_36086,1,70339,70339,103506,33167,33167,1973,0,0,0
103596,application_1508364558011_24812,1,57374,57374,103596,46222,46222,1113,0,0,0
103596,application_1506638472019_23222,1,27169,27169,103596,76427,76427,2794,0,0,0
103616,application_1506638472019_29768,1,30308,30308,103616,73308,73308,3740,0,0,0
103616,application_1508364558011_33672,1,69539,69539,103616,34077,34077,1460,0,0,0
103636,application_1508364558011_2060,1,38859,38859,103636,64777,64777,1721,0,0,0
103666,application_1511916184019_0277,1,96901,96901,103666,6765,6765,1618,0,0,0
103686,application_1506638472019_23251,1,27171,27171,103686,76515,76515,2632,0,0,0
103736,application_1508364558011_24781,1,57371,57371,103736,46365,46365,1328,0,0,0
103736,application_1506638472019_18030,1,24515,24515,103736,79221,79221,2036,0,0,0
103746,application_1506638472019_26751,1,28571,28571,103746,75175,75175,3464,0,0,0
103756,application_1508364558011_23200,1,55845,55845,103756,47911,47911,927,0,0,0
103756,application_1506638472019_16824,1,23298,23298,103756,80458,80458,2890,0,0,0
103786,application_1506638472019_18716,1,24625,24625,103786,79161,79161,2037,0,0,0
103796,application_1506638472019_23534,1,27205,27205,103796,76591,76591,2682,0,0,0
103826,application_1506638472019_27156,1,28711,28711,103826,75115,75115,3616,0,0,0
103836,application_1508364558011_34281,1,69765,69765,103836,34071,34071,925,0,0,0
103916,application_1508364558011_37295,1,72291,72291,103916,31625,31625,1354,0,0,0
103926,application_1508364558011_33567,1,69525,69525,103926,34401,34401,811,0,0,0
103946,application_1506638472019_4886,1,15806,15806,103946,88140,88140,4714,0,0,0
103956,application_1506638472019_28298,1,29138,29138,103956,74818,74818,2470,0,0,0
103976,application_1506638472019_28554,1,29191,29191,103976,74785,74785,3992,0,0,0
103976,application_1511916184019_1833,1,99936,99936,103976,4040,4040,60,0,0,0
103981,application_1508364558011_15948,4,46323,46323,103981,57658,57658,2030,0,0,0
104001,application_1506638472019_30386,1,30958,30958,104001,73043,73043,2029,0,0,0
104001,application_1508364558011_44501,1,78161,78161,104001,25840,25840,456,0,0,0
104011,application_1508364558011_52773,2,89236,89236,104011,14775,14775,26,0,0,0
104011,application_1508364558011_52930,2,89513,89513,104011,14498,14498,29,0,0,0
104031,application_1508364558011_18951,1,48247,48247,104031,55784,55784,1390,0,0,0
104031,application_1508364558011_20739,1,50008,50008,104031,54023,54023,1779,0,0,0
104041,application_1506638472019_9066,1,17577,17577,104041,86464,86464,2761,0,0,0
104061,application_1508364558011_4401,1,39365,39365,104061,64696,64696,1432,0,0,0
104061,application_1508364558011_43851,1,77921,77921,104061,26140,26140,457,0,0,0
104071,application_1508364558011_3941,1,39298,39298,104071,64773,64773,1511,0,0,0
104081,application_1508364558011_30421,1,66905,66905,104081,37176,37176,521,0,0,0
104153,application_1508364558011_7375,1,41281,41281,104153,62872,62872,1667,0,0,0
104196,application_1508364558011_24928,1,57395,57395,104196,46801,46801,1476,0,0,0
104238,application_1506638472019_31197,1,31206,31206,104238,73032,73032,2044,0,0,0
104278,application_1508364558011_51933,1,87873,87873,104278,16405,16405,581,0,0,0
104290,application_1506638472019_8198,1,17301,17301,104290,86989,86989,2540,0,0,0
104361,application_1508364558011_15375,1,45569,45569,104361,58792,58792,1354,0,0,0
104416,application_1508364558011_13802,1,44695,44695,104416,59721,59721,1441,0,0,0
104416,application_1508364558011_2409,1,39010,39010,104416,65406,65406,1618,0,0,0
104426,application_1506638472019_30587,1,31000,31000,104426,73426,73426,2037,0,0,0
104426,application_1508364558011_45055,1,78236,78236,104426,26190,26190,455,0,0,0
104430,application_1508364558011_1870,1,38852,38852,104430,65578,65578,1602,0,0,0
104440,application_1506638472019_28951,1,29315,29315,104440,75125,75125,2492,0,0,0
104441,application_1506638472019_9027,1,17572,17572,104441,86869,86869,2784,0,0,0
104451,application_1508364558011_11326,1,43061,43061,104451,61390,61390,1361,0,0,0
104471,application_1508364558011_23245,1,55849,55849,104471,48622,48622,1332,0,0,0
104524,application_1508364558011_12403,1,43574,43574,104524,60950,60950,1251,0,0,0
104524,application_1506638472019_8876,1,17550,17550,104524,86974,86974,2648,0,0,0
104544,application_1506638472019_21635,1,26310,26310,104544,78234,78234,2033,0,0,0
104554,application_1511528684064_0495,1,92637,92637,104554,11917,11917,262,0,0,0
104566,application_1511916184019_1711,1,99767,99767,104566,4799,4799,332,0,0,0
104566,application_1511916184019_1677,1,99759,99759,104566,4807,4807,332,0,0,0
104599,application_1508364558011_4931,1,39810,39810,104599,64789,64789,1754,0,0,0
104609,application_1511916184019_2352,1,101322,101322,104609,3287,3287,325,0,0,0
104619,application_1508364558011_13804,1,44695,44695,104619,59924,59924,1568,0,0,0
104619,application_1511916184019_2425,1,101342,101342,104619,3277,3277,336,0,0,0
104629,application_1506638472019_28391,1,29152,29152,104629,75477,75477,2355,0,0,0
104639,application_1506638472019_16858,1,23304,23304,104639,81335,81335,2790,0,0,0
104659,application_1506638472019_16692,1,23272,23272,104659,81387,81387,2627,0,0,0
104659,application_1508364558011_15159,1,45566,45566,104659,59093,59093,1452,0,0,0
104679,application_1506638472019_19798,1,24984,24984,104679,79695,79695,1835,0,0,0
104679,application_1508364558011_21456,1,50727,50727,104679,53952,53952,1379,0,0,0
104709,application_1506638472019_16453,1,23147,23147,104709,81562,81562,2823,0,0,0
104719,application_1506638472019_6799,1,17133,17133,104719,87586,87586,2639,0,0,0
104729,application_1506638472019_23122,1,27161,27161,104729,77568,77568,2672,0,0,0
104739,application_1508364558011_5034,1,39860,39860,104739,64879,64879,1872,0,0,0
104749,application_1508364558011_8863,1,41848,41848,104749,62901,62901,1565,0,0,0
104775,application_1508364558011_3602,1,39251,39251,104775,65524,65524,2656,0,0,0
104833,application_1508364558011_33791,1,69689,69689,104833,35144,35144,1132,0,0,0
104833,application_1506638472019_22933,1,27006,27006,104833,77827,77827,2524,0,0,0
104833,application_1508364558011_18822,1,48069,48069,104833,56764,56764,1440,0,0,0
104873,application_1508364558011_2474,1,39015,39015,104873,65858,65858,2308,0,0,0
104886,application_1506638472019_21403,1,26287,26287,104886,78599,78599,2397,0,0,0
104896,application_1506638472019_28529,1,29185,29185,104896,75711,75711,2503,0,0,0
104906,application_1506638472019_5483,1,15895,15895,104906,89011,89011,3456,0,0,0
104936,application_1508364558011_7139,1,41278,41278,104936,63658,63658,2220,0,0,0
104971,application_1508364558011_9280,1,42060,42060,104971,62911,62911,1805,0,0,0
104971,application_1506638472019_23165,1,27164,27164,104971,77807,77807,2569,0,0,0
104971,application_1506638472019_24549,1,27702,27702,104971,77269,77269,2657,0,0,0
104971,application_1508364558011_6552,1,40811,40811,104971,64160,64160,1961,0,0,0
105006,application_1511916184019_1309,1,99277,99277,105006,5729,5729,50,0,0,0
105016,application_1508364558011_33797,1,69689,69689,105016,35327,35327,599,0,0,0
105016,application_1506638472019_12453,1,18965,18965,105016,86051,86051,2554,0,0,0
105026,application_1508364558011_3781,1,39289,39289,105026,65737,65737,1461,0,0,0
105034,application_1511916184019_1140,1,98966,98966,105034,6068,6068,70,0,0,0
105046,application_1508364558011_44144,1,78097,78097,105046,26949,26949,501,0,0,0
105116,application_1506638472019_30164,1,30933,30933,105116,74183,74183,1983,0,0,0
105126,application_1511916184019_1954,1,100357,100357,105126,4769,4769,67,0,0,0
105139,application_1508364558011_11111,1,42996,42996,105139,62143,62143,1345,0,0,0
105139,application_1511916184019_1549,1,99606,99606,105139,5533,5533,70,0,0,0
105139,application_1508364558011_5557,1,40036,40036,105139,65103,65103,1291,0,0,0
105149,application_1506638472019_30568,1,30997,30997,105149,74152,74152,2042,0,0,0
105179,application_1511916184019_2170,1,100826,100826,105179,4353,4353,67,0,0,0
105189,application_1506638472019_6549,1,17078,17078,105189,88111,88111,2524,0,0,0
105194,application_1508364558011_11734,1,43440,43440,105194,61754,61754,1309,0,0,0
105194,application_1511916184019_2133,1,100792,100792,105194,4402,4402,32,0,0,0
105226,application_1508364558011_11225,1,43015,43015,105226,62211,62211,1324,0,0,0
105241,application_1508364558011_44122,1,78095,78095,105241,27146,27146,489,0,0,0
105266,application_1511916184019_2159,1,100823,100823,105266,4443,4443,27,0,0,0
105286,application_1506638472019_6502,1,17073,17073,105286,88213,88213,2490,0,0,0
105286,application_1508364558011_11612,1,43301,43301,105286,61985,61985,1137,0,0,0
105286,application_1508364558011_47336,1,80526,80526,105286,24760,24760,341,0,0,0
105290,application_1508364558011_15362,1,45569,45569,105290,59721,59721,1325,0,0,0
105312,application_1506638472019_31185,1,31202,31202,105312,74110,74110,1952,0,0,0
105312,application_1508364558011_12531,1,43584,43584,105312,61728,61728,1504,0,0,0
105322,application_1506638472019_18254,1,24565,24565,105322,80757,80757,2041,0,0,0
105336,application_1511528684064_0217,1,91090,91090,105336,14246,14246,318,0,0,0
105344,application_1511916184019_1889,1,100076,100076,105344,5268,5268,65,0,0,0
105367,application_1511916184019_1159,1,99016,99016,105367,6351,6351,58,0,0,0
105377,application_1508364558011_16105,1,46389,46389,105377,58988,58988,1269,0,0,0
105377,application_1506638472019_8897,1,17554,17554,105377,87823,87823,2668,0,0,0
105396,application_1508364558011_37701,1,72325,72325,105396,33071,33071,505,0,0,0
105429,application_1506638472019_17965,1,24509,24509,105429,80920,80920,2108,0,0,0
105439,application_1511916184019_1311,1,99286,99286,105439,6153,6153,64,0,0,0
105459,application_1506638472019_7445,1,17219,17219,105459,88240,88240,2552,0,0,0
105462,application_1511916184019_0432,1,97511,97511,105462,7951,7951,64,0,0,0
105472,application_1508364558011_8269,1,41626,41626,105472,63846,63846,1251,0,0,0
105482,application_1511916184019_1291,1,99246,99246,105482,6236,6236,74,0,0,0
105492,application_1511916184019_1599,1,99682,99682,105492,5810,5810,1097,0,0,0
105516,application_1506638472019_8860,1,17548,17548,105516,87968,87968,2764,0,0,0
105536,application_1508364558011_39715,1,73764,73764,105536,31772,31772,582,0,0,0
105558,application_1506638472019_5585,1,15899,15899,105558,89659,89659,3342,0,0,0
105558,application_1508364558011_16668,1,46689,46689,105558,58869,58869,1719,0,0,0
105560,application_1508364558011_29437,1,65991,65991,105560,39569,39569,899,0,0,0
105580,application_1508364558011_7007,1,41187,41187,105580,64393,64393,1884,0,0,0
105619,application_1506638472019_18151,1,24538,24538,105619,81081,81081,2153,0,0,0
105629,application_1508364558011_33877,1,69697,69697,105629,35932,35932,756,0,0,0
105639,application_1508364558011_45524,1,78345,78345,105639,27294,27294,530,0,0,0
105656,application_1511916184019_3083,1,103981,103981,105656,1675,1675,27,0,0,0
105686,application_1508364558011_5098,1,39861,39861,105686,65825,65825,1501,0,0,0
105696,application_1511916184019_2240,1,100886,100886,105696,4810,4810,63,0,0,0
105711,application_1512440382012_0107,1,105270,105270,105711,441,441,19,0,0,0
105731,application_1506638472019_8041,1,17284,17284,105731,88447,88447,2634,0,0,0
105741,application_1508364558011_36275,8,70519,70519,105741,35222,35222,618,0,0,0
105751,application_1508364558011_37313,1,72293,72293,105751,33458,33458,380,0,0,0
105761,application_1508364558011_20985,1,50266,50266,105761,55495,55495,1026,0,0,0
105781,application_1511916184019_1069,1,98746,98746,105781,7035,7035,66,0,0,0
105826,application_1508364558011_13758,1,44693,44693,105826,61133,61133,1139,0,0,0
105856,application_1512440382012_0103,1,105267,105267,105856,589,589,17,0,0,0
105876,application_1511916184019_0396,1,97347,97347,105876,8529,8529,105,0,0,0
105900,application_1511916184019_3526,1,104579,104579,105900,1321,1321,21,0,0,0
105906,application_1506638472019_17750,1,24474,24474,105906,81432,81432,2119,0,0,0
105906,application_1508364558011_33485,8,69492,69492,105906,36414,36414,188,0,0,0
105926,application_1511528684064_0352,2,91800,91800,105926,14126,14126,18,0,0,0
105926,application_1511528684064_0357,2,91826,91826,105926,14100,14100,21,0,0,0
105936,application_1506638472019_18525,1,24605,24605,105936,81331,81331,2044,0,0,0
105946,application_1511528684064_0478,2,92541,92541,105946,13405,13405,18,0,0,0
105961,application_1511916184019_1918,1,100186,100186,105961,5775,5775,74,0,0,0
105961,application_1511528684064_0614,2,93283,93283,105961,12678,12678,26,0,0,0
105971,application_1511916184019_1895,1,100096,100096,105971,5875,5875,78,0,0,0
105971,application_1511528684064_0661,2,93595,93595,105971,12376,12376,19,0,0,0
105981,application_1511528684064_0748,2,93853,93853,105981,12128,12128,20,0,0,0
105991,application_1508364558011_39685,1,73762,73762,105991,32229,32229,605,0,0,0
106001,application_1511528684064_1036,2,94630,94630,106001,11371,11371,24,0,0,0
106061,application_1511916184019_1245,1,99197,99197,106061,6864,6864,72,0,0,0
106061,application_1508364558011_8733,1,41647,41647,106061,64414,64414,1568,0,0,0
106075,application_1508364558011_44708,1,78177,78177,106075,27898,27898,456,0,0,0
106095,application_1508364558011_42537,1,76600,76600,106095,29495,29495,461,0,0,0
106105,application_1506638472019_18582,1,24611,24611,106105,81494,81494,2067,0,0,0
106144,application_1511528684064_2778,1,96427,96427,106144,9717,9717,97,0,0,0
106152,application_1508364558011_40039,1,73794,73794,106152,32358,32358,575,0,0,0
106173,application_1508364558011_3385,1,39227,39227,106173,66946,66946,1699,0,0,0
106173,application_1508364558011_17625,1,47664,47664,106173,58509,58509,1377,0,0,0
106173,application_1508364558011_43934,1,77928,77928,106173,28245,28245,579,0,0,0
106187,application_1506638472019_8968,1,17564,17564,106187,88623,88623,2782,0,0,0
106197,application_1508364558011_39726,1,73765,73765,106197,32432,32432,578,0,0,0
106217,application_1506638472019_3371,1,13425,13425,106217,92792,92792,3619,0,0,0
106221,application_1506638472019_30688,1,31014,31014,106221,75207,75207,2022,0,0,0
106221,application_1511916184019_1228,8,99140,99140,106221,7081,7081,88,0,0,0
106231,application_1506638472019_12180,1,18824,18824,106231,87407,87407,2606,0,0,0
106231,application_1506638472019_8016,1,17281,17281,106231,88950,88950,2696,0,0,0
106231,application_1511916184019_3830,4,105194,105194,106231,1037,1037,54,0,0,0
106256,application_1506638472019_12171,1,18823,18823,106256,87433,87433,2568,0,0,0
106256,application_1506638472019_18148,1,24537,24537,106256,81719,81719,2134,0,0,0
106276,application_1512440382012_0161,1,105396,105396,106276,880,880,59,0,0,0
106286,application_1511916184019_2213,1,100859,100859,106286,5427,5427,48,0,0,0
106286,application_1511916184019_0099,1,96598,96598,106286,9688,9688,82,0,0,0
106308,application_1506638472019_7042,1,17155,17155,106308,89153,89153,2501,0,0,0
106328,application_1508364558011_40433,1,73904,73904,106328,32424,32424,520,0,0,0
106328,application_1506638472019_30920,1,31038,31038,106328,75290,75290,1950,0,0,0
106338,application_1508364558011_44171,1,78100,78100,106338,28238,28238,464,0,0,0
106338,application_1508364558011_10083,1,42145,42145,106338,64193,64193,1610,0,0,0
106356,application_1506638472019_9022,1,17571,17571,106356,88785,88785,2708,0,0,0
106356,application_1511916184019_3399,1,104416,104416,106356,1940,1940,66,0,0,0
106366,application_1511916184019_1594,1,99676,99676,106366,6690,6690,71,0,0,0
106410,application_1506638472019_17911,1,24503,24503,106410,81907,81907,2146,0,0,0
106430,application_1511916184019_2547,1,101996,101996,106430,4434,4434,67,0,0,0
106430,application_1508364558011_37353,1,72296,72296,106430,34134,34134,507,0,0,0
106440,application_1511916184019_3525,1,104578,104578,106440,1862,1862,57,0,0,0
106450,application_1506638472019_7667,1,17243,17243,106450,89207,89207,2534,0,0,0
106450,application_1506638472019_8872,1,17549,17549,106450,88901,88901,2546,0,0,0
106455,application_1506638472019_30655,1,31007,31007,106455,75448,75448,2157,0,0,0
106465,application_1506638472019_16484,1,23153,23153,106465,83312,83312,2923,0,0,0
106475,application_1511916184019_2446,1,101446,101446,106475,5029,5029,67,0,0,0
106475,application_1508364558011_34963,1,69870,69870,106475,36605,36605,525,0,0,0
106475,application_1511528684064_1454,2,95519,95519,106475,10956,10956,29,0,0,0
106485,application_1511528684064_1521,2,95664,95664,106485,10821,10821,38,0,0,0
106515,application_1508364558011_4097,1,39359,39359,106515,67156,67156,1575,0,0,0
106515,application_1511916184019_2152,1,100816,100816,106515,5699,5699,60,0,0,0
106515,application_1508364558011_14720,1,45309,45309,106515,61206,61206,2152,0,0,0
106520,application_1508364558011_39686,1,73762,73762,106520,32758,32758,592,0,0,0
106540,application_1508364558011_18843,1,48070,48070,106540,58470,58470,1262,0,0,0
106571,application_1506638472019_16261,1,23108,23108,106571,83463,83463,2841,0,0,0
106601,application_1511916184019_2934,1,103746,103746,106601,2855,2855,59,0,0,0
106621,application_1511916184019_1961,1,100376,100376,106621,6245,6245,62,0,0,0
106621,application_1508364558011_21171,1,50537,50537,106621,56084,56084,1458,0,0,0
106651,application_1508364558011_14836,1,45368,45368,106651,61283,61283,1217,0,0,0
106664,application_1506638472019_4047,1,14319,14319,106664,92345,92345,3601,0,0,0
106674,application_1506638472019_18288,1,24569,24569,106674,82105,82105,2055,0,0,0
106686,application_1508364558011_44119,1,78095,78095,106686,28591,28591,450,0,0,0
106726,application_1511916184019_3831,1,105196,105196,106726,1530,1530,64,0,0,0
106736,application_1508364558011_36786,8,71355,71355,106736,35381,35381,198,0,0,0
106756,application_1506638472019_5838,1,15970,15970,106756,90786,90786,3195,0,0,0
106789,application_1508364558011_44538,1,78164,78164,106789,28625,28625,459,0,0,0
106828,application_1508364558011_16381,1,46505,46505,106828,60323,60323,1121,0,0,0
106838,application_1508364558011_5001,1,39859,39859,106838,66979,66979,2185,0,0,0
106856,application_1508364558011_37334,1,72295,72295,106856,34561,34561,595,0,0,0
106856,application_1508364558011_45495,1,78341,78341,106856,28515,28515,519,0,0,0
106856,application_1511916184019_1198,1,99076,99076,106856,7780,7780,92,0,0,0
106856,application_1508364558011_18728,1,48014,48014,106856,58842,58842,1182,0,0,0
106866,application_1508364558011_27346,1,60251,60251,106866,46615,46615,956,0,0,0
106866,application_1508364558011_24996,1,57401,57401,106866,49465,49465,809,0,0,0
106876,application_1512440382012_0251,1,105516,105516,106876,1360,1360,61,0,0,0
106882,application_1511916184019_1224,1,99132,99132,106882,7750,7750,103,0,0,0
106882,application_1511916184019_1996,1,100446,100446,106882,6436,6436,74,0,0,0
106886,application_1506638472019_18596,1,24612,24612,106886,82274,82274,2246,0,0,0
106916,application_1508364558011_36340,8,70598,70598,106916,36318,36318,514,0,0,0
106936,application_1508364558011_9869,1,42139,42139,106936,64797,64797,1359,0,0,0
106946,application_1512440382012_1015,1,106686,106686,106946,260,260,8,0,0,0
106957,application_1511916184019_2139,1,100796,100796,106957,6161,6161,68,0,0,0
106964,application_1508364558011_43847,1,77920,77920,106964,29044,29044,521,0,0,0
106984,application_1511916184019_1772,1,99843,99843,106984,7141,7141,109,0,0,0
106996,application_1504131676014_20200,1,2411,2411,106996,104585,104585,11279,0,0,0
106996,application_1506638472019_30601,1,31002,31002,106996,75994,75994,2013,0,0,0
107031,application_1506638472019_8181,1,17298,17298,107031,89733,89733,2672,0,0,0
107041,application_1506638472019_6244,1,16889,16889,107041,90152,90152,2452,0,0,0
107041,application_1508364558011_45511,1,78342,78342,107041,28699,28699,466,0,0,0
107056,application_1511916184019_0179,1,96776,96776,107056,10280,10280,127,0,0,0
107056,application_1511916184019_3808,1,105151,105151,107056,1905,1905,77,0,0,0
107066,application_1511916184019_2522,1,101806,101806,107066,5260,5260,60,0,0,0
107066,application_1508364558011_44833,1,78211,78211,107066,28855,28855,562,0,0,0
107086,application_1506638472019_30714,1,31017,31017,107086,76069,76069,2104,0,0,0
107106,application_1506638472019_17919,1,24504,24504,107106,82602,82602,2099,0,0,0
107106,application_1506638472019_8904,1,17555,17555,107106,89551,89551,2807,0,0,0
107116,application_1506638472019_18985,1,24804,24804,107116,82312,82312,1914,0,0,0
107116,application_1511916184019_2723,1,102586,102586,107116,4530,4530,68,0,0,0
107136,application_1508364558011_17590,1,47663,47663,107136,59473,59473,1417,0,0,0
107136,application_1506638472019_17052,1,23340,23340,107136,83796,83796,2921,0,0,0
107146,application_1511916184019_0461,1,97574,97574,107146,9572,9572,233,0,0,0
107156,application_1511916184019_3695,1,104943,104943,107156,2213,2213,68,0,0,0
107156,application_1511916184019_2196,1,100845,100845,107156,6311,6311,68,0,0,0
107174,application_1511916184019_2860,1,103246,103246,107174,3928,3928,67,0,0,0
107184,application_1511916184019_2912,1,103616,103616,107184,3568,3568,66,0,0,0
107184,application_1508364558011_8009,1,41622,41622,107184,65562,65562,1902,0,0,0
107194,application_1511916184019_1244,1,99196,99196,107194,7998,7998,67,0,0,0
107194,application_1511916184019_2590,1,102112,102112,107194,5082,5082,62,0,0,0
107194,application_1506638472019_5303,1,15822,15822,107194,91372,91372,4052,0,0,0
107194,application_1508364558011_45454,1,78335,78335,107194,28859,28859,628,0,0,0
107202,application_1511916184019_1204,1,99084,99084,107202,8118,8118,81,0,0,0
107202,application_1511916184019_2639,1,102316,102316,107202,4886,4886,61,0,0,0
107216,application_1508364558011_34286,1,69766,69766,107216,37450,37450,886,0,0,0
107246,application_1511916184019_1535,1,99576,99576,107246,7670,7670,112,0,0,0
107266,application_1511916184019_3728,1,105006,105006,107266,2260,2260,80,0,0,0
107266,application_1511916184019_2592,1,102115,102115,107266,5151,5151,59,0,0,0
107286,application_1508364558011_37907,8,72782,72782,107286,34504,34504,203,0,0,0
107296,application_1508364558011_39258,1,73634,73634,107296,33662,33662,591,0,0,0
107296,application_1511916184019_2492,1,101656,101656,107296,5640,5640,60,0,0,0
107326,application_1508364558011_19405,1,48801,48801,107326,58525,58525,1533,0,0,0
107334,application_1506638472019_11856,1,18788,18788,107334,88546,88546,2560,0,0,0
107344,application_1508364558011_3966,1,39299,39299,107344,68045,68045,1728,0,0,0
107361,application_1506638472019_8151,1,17293,17293,107361,90068,90068,2671,0,0,0
107368,application_1511916184019_3715,1,104986,104986,107368,2382,2382,68,0,0,0
107381,application_1511916184019_2768,1,102786,102786,107381,4595,4595,74,0,0,0
107391,application_1511916184019_3489,1,104484,104484,107391,2907,2907,116,0,0,0
107401,application_1512440382012_0972,1,106652,106652,107401,749,749,44,0,0,0
107401,application_1508364558011_19747,1,49147,49147,107401,58254,58254,1630,0,0,0
107406,application_1511916184019_3138,1,104096,104096,107406,3310,3310,70,0,0,0
107406,application_1504131676014_24415,1,6785,6785,107406,100621,100621,6970,0,0,0
107436,application_1508364558011_17501,1,47492,47492,107436,59944,59944,1494,0,0,0
107446,application_1508364558011_15300,1,45568,45568,107446,61878,61878,1320,0,0,0
107456,application_1508364558011_7060,1,41191,41191,107456,66265,66265,1846,0,0,0
107478,application_1508364558011_39684,1,73762,73762,107478,33716,33716,506,0,0,0
107478,application_1508364558011_5202,1,39864,39864,107478,67614,67614,1311,0,0,0
107498,application_1506638472019_18110,1,24534,24534,107498,82964,82964,2128,0,0,0
107498,application_1511916184019_3740,1,105036,105036,107498,2462,2462,66,0,0,0
107508,application_1506638472019_5582,1,15898,15898,107508,91610,91610,3140,0,0,0
107546,application_1511916184019_1263,1,99238,99238,107546,8308,8308,95,0,0,0
107546,application_1508364558011_39465,1,73652,73652,107546,33894,33894,586,0,0,0
107556,application_1511916184019_3008,1,103866,103866,107556,3690,3690,72,0,0,0
107556,application_1511916184019_2012,1,100508,100508,107556,7048,7048,103,0,0,0
107566,application_1506638472019_17984,1,24511,24511,107566,83055,83055,2092,0,0,0
107566,application_1508364558011_12476,1,43577,43577,107566,63989,63989,1255,0,0,0
107566,application_1506638472019_30427,1,30962,30962,107566,76604,76604,1996,0,0,0
107585,application_1506638472019_18714,1,24625,24625,107585,82960,82960,2168,0,0,0
107585,application_1508364558011_37221,1,72286,72286,107585,35299,35299,532,0,0,0
107585,application_1508364558011_24701,1,57338,57338,107585,50247,50247,979,0,0,0
107605,application_1508364558011_5611,1,40037,40037,107605,67568,67568,1343,0,0,0
107625,application_1511916184019_3517,1,104556,104556,107625,3069,3069,31,0,0,0
107625,application_1508364558011_9842,1,42138,42138,107625,65487,65487,1521,0,0,0
107625,application_1511916184019_3009,1,103876,103876,107625,3749,3749,70,0,0,0
107665,application_1511916184019_3669,1,104876,104876,107665,2789,2789,72,0,0,0
107665,application_1512440382012_0692,1,106236,106236,107665,1429,1429,63,0,0,0
107675,application_1512440382012_0709,1,106256,106256,107675,1419,1419,64,0,0,0
107685,application_1511916184019_1121,1,98896,98896,107685,8789,8789,73,0,0,0
107685,application_1506638472019_30113,1,30927,30927,107685,76758,76758,2037,0,0,0
107695,application_1506638472019_18510,1,24604,24604,107695,83091,83091,2142,0,0,0
107695,application_1511916184019_2803,1,102996,102996,107695,4699,4699,81,0,0,0
107705,application_1508364558011_11014,1,42907,42907,107705,64798,64798,1290,0,0,0
107735,application_1512440382012_0784,1,106391,106391,107735,1344,1344,54,0,0,0
107735,application_1506638472019_30033,1,30919,30919,107735,76816,76816,1937,0,0,0
107745,application_1511916184019_2120,1,100754,100754,107745,6991,6991,93,0,0,0
107745,application_1508364558011_24440,1,56911,56911,107745,50834,50834,957,0,0,0
107755,application_1511916184019_3293,1,104266,104266,107755,3489,3489,64,0,0,0
107755,application_1511916184019_0832,1,98246,98246,107755,9509,9509,107,0,0,0
107795,application_1506638472019_18551,1,24608,24608,107795,83187,83187,2195,0,0,0
107815,application_1508364558011_39850,1,73776,73776,107815,34039,34039,512,0,0,0
107837,application_1506638472019_18257,1,24566,24566,107837,83271,83271,2070,0,0,0
107846,application_1506638472019_24150,1,27348,27348,107846,80498,80498,2693,0,0,0
107852,application_1511916184019_2727,1,102606,102606,107852,5246,5246,65,0,0,0
107862,application_1511916184019_3607,1,104762,104762,107862,3100,3100,73,0,0,0
107862,application_1511916184019_2769,1,102796,102796,107862,5066,5066,75,0,0,0
107862,application_1508364558011_37673,1,72323,72323,107862,35539,35539,727,0,0,0
107865,application_1511916184019_2822,1,103066,103066,107865,4799,4799,68,0,0,0
107876,application_1512440382012_0715,1,106266,106266,107876,1610,1610,67,0,0,0
107936,application_1508364558011_28721,1,64731,64731,107936,43205,43205,729,0,0,0
107986,application_1508364558011_17603,1,47664,47664,107986,60322,60322,1269,0,0,0
107986,application_1511528684064_1641,1,95955,95955,107986,12031,12031,200,0,0,0
108006,application_1508364558011_45516,1,78343,78343,108006,29663,29663,515,0,0,0
108026,application_1508364558011_39435,1,73650,73650,108026,34376,34376,744,0,0,0
108036,application_1512440382012_0112,1,105276,105276,108036,2760,2760,63,0,0,0
108046,application_1506638472019_17431,1,23825,23825,108046,84221,84221,2228,0,0,0
108056,application_1511916184019_3612,1,104765,104765,108056,3291,3291,75,0,0,0
108056,application_1506638472019_7502,1,17224,17224,108056,90832,90832,2704,0,0,0
108066,application_1508364558011_8407,1,41641,41641,108066,66425,66425,1488,0,0,0
108066,application_1506638472019_17777,1,24479,24479,108066,83587,83587,2097,0,0,0
108076,application_1511916184019_3734,1,105026,105026,108076,3050,3050,66,0,0,0
108098,application_1508364558011_8632,1,41645,41645,108098,66453,66453,1774,0,0,0
108098,application_1508364558011_2572,1,39024,39024,108098,69074,69074,1682,0,0,0
108108,application_1508364558011_12561,1,43585,43585,108108,64523,64523,1407,0,0,0
108108,application_1506638472019_18066,1,24519,24519,108108,83589,83589,2039,0,0,0
108108,application_1506638472019_28935,1,29313,29313,108108,78795,78795,2327,0,0,0
108147,application_1508364558011_45120,1,78242,78242,108147,29905,29905,502,0,0,0
108147,application_1511916184019_2312,1,101216,101216,108147,6931,6931,86,0,0,0
108157,application_1511916184019_3816,1,105159,105159,108157,2998,2998,98,0,0,0
108167,application_1508364558011_17472,1,47486,47486,108167,60681,60681,1912,0,0,0
108177,application_1506638472019_30999,1,31047,31047,108177,77130,77130,1991,0,0,0
108187,application_1511916184019_3468,1,104483,104483,108187,3704,3704,111,0,0,0
108225,application_1511916184019_2273,1,101086,101086,108225,7139,7139,71,0,0,0
108225,application_1506638472019_9053,1,17576,17576,108225,90649,90649,2764,0,0,0
108236,application_1508364558011_7382,1,41281,41281,108236,66955,66955,1519,0,0,0
108246,application_1512440382012_0006,1,105216,105216,108246,3030,3030,63,0,0,0
108246,application_1508364558011_40180,1,73806,73806,108246,34440,34440,834,0,0,0
108276,application_1508364558011_23251,1,55850,55850,108276,52426,52426,1170,0,0,0
108276,application_1508364558011_13475,1,44655,44655,108276,63621,63621,1539,0,0,0
108276,application_1511916184019_1212,1,99096,99096,108276,9180,9180,77,0,0,0
108296,application_1506638472019_28013,1,29075,29075,108296,79221,79221,2304,0,0,0
108310,application_1511916184019_3481,1,104483,104483,108310,3827,3827,111,0,0,0
108361,application_1506638472019_18746,1,24628,24628,108361,83733,83733,2108,0,0,0
108397,application_1508364558011_42677,1,76658,76658,108397,31739,31739,823,0,0,0
108397,application_1508364558011_14755,1,45315,45315,108397,63082,63082,1392,0,0,0
108407,application_1511916184019_2635,1,102296,102296,108407,6111,6111,68,0,0,0
108407,application_1508364558011_11444,1,43293,43293,108407,65114,65114,1220,0,0,0
108417,application_1506638472019_16922,1,23316,23316,108417,85101,85101,2747,0,0,0
108417,application_1508364558011_4792,1,39806,39806,108417,68611,68611,1617,0,0,0
108445,application_1508364558011_16151,1,46392,46392,108445,62053,62053,1176,0,0,0
108455,application_1506638472019_7780,1,17259,17259,108455,91196,91196,2505,0,0,0
108465,application_1508364558011_26100,1,58467,58467,108465,49998,49998,1339,0,0,0
108472,application_1511916184019_3644,1,104823,104823,108472,3649,3649,79,0,0,0
108493,application_1506638472019_4869,1,15805,15805,108493,92688,92688,3569,0,0,0
108524,application_1511916184019_3393,1,104411,104411,108524,4113,4113,108,0,0,0
108524,application_1512440382012_1566,1,107912,107912,108524,612,612,45,0,0,0
108544,application_1508364558011_7205,1,41279,41279,108544,67265,67265,1457,0,0,0
108564,application_1508364558011_39392,1,73646,73646,108564,34918,34918,597,0,0,0
108574,application_1506638472019_17958,1,24508,24508,108574,84066,84066,2039,0,0,0
108594,application_1511916184019_2233,1,100871,100871,108594,7723,7723,64,0,0,0
108594,application_1512440382012_0051,1,105255,105255,108594,3339,3339,103,0,0,0
108594,application_1512440382012_1107,1,106886,106886,108594,1708,1708,55,0,0,0
108604,application_1511916184019_2144,1,100806,100806,108604,7798,7798,64,0,0,0
108616,application_1506638472019_7707,1,17248,17248,108616,91368,91368,2732,0,0,0
108636,application_1508364558011_45503,1,78342,78342,108636,30294,30294,567,0,0,0
108666,application_1506638472019_18403,1,24592,24592,108666,84074,84074,2138,0,0,0
108669,application_1511916184019_2435,1,101366,101366,108669,7303,7303,110,0,0,0
108696,application_1512440382012_1010,1,106676,106676,108696,2020,2020,46,0,0,0
108706,application_1508364558011_14447,1,45027,45027,108706,63679,63679,1339,0,0,0
108726,application_1508364558011_2573,1,39025,39025,108726,69701,69701,1503,0,0,0
108735,application_1508364558011_44139,1,78097,78097,108735,30638,30638,463,0,0,0
108745,application_1506638472019_30343,1,30953,30953,108745,77792,77792,1961,0,0,0
108749,application_1508364558011_21018,1,50268,50268,108749,58481,58481,1327,0,0,0
108769,application_1508364558011_27441,1,60469,60469,108769,48300,48300,927,0,0,0
108769,application_1512440382012_0463,1,105906,105906,108769,2863,2863,69,0,0,0
108779,application_1511916184019_2537,1,101926,101926,108779,6853,6853,63,0,0,0
108801,application_1511528684064_1638,1,95945,95945,108801,12856,12856,161,0,0,0
108811,application_1511916184019_2854,1,103206,103206,108811,5605,5605,61,0,0,0
108811,application_1508364558011_14548,1,45142,45142,108811,63669,63669,1141,0,0,0
108831,application_1508364558011_34082,4,69738,69738,108831,39093,39093,316,0,0,0
108841,application_1506638472019_8640,1,17430,17430,108841,91411,91411,3953,0,0,0
108841,application_1511916184019_2634,1,102286,102286,108841,6555,6555,72,0,0,0
108841,application_1508364558011_36503,1,70800,70800,108841,38041,38041,771,0,0,0
108841,application_1508364558011_35854,4,70128,70128,108841,38713,38713,292,0,0,0
108851,application_1506638472019_27951,1,29066,29066,108851,79785,79785,2490,0,0,0
108870,application_1508364558011_10423,1,42150,42150,108870,66720,66720,1296,0,0,0
108870,application_1508364558011_26202,1,58595,58595,108870,50275,50275,1006,0,0,0
108880,application_1508364558011_49879,1,86380,86380,108880,22500,22500,575,0,0,0
108890,application_1511916184019_3284,1,104261,104261,108890,4629,4629,108,0,0,0
108910,application_1508364558011_10628,1,42170,42170,108910,66740,66740,1287,0,0,0
108916,application_1511916184019_0106,2,96607,96607,108916,12309,12309,16,0,0,0
108926,application_1511528684064_2560,2,96310,96310,108926,12616,12616,22,0,0,0
108938,application_1511916184019_0165,2,96755,96755,108938,12183,12183,16,0,0,0
108939,application_1511916184019_2581,1,102106,102106,108939,6833,6833,65,0,0,0
108976,application_1506638472019_17755,1,24475,24475,108976,84501,84501,2063,0,0,0
108986,application_1506638472019_18109,1,24534,24534,108986,84452,84452,2097,0,0,0
108996,application_1508364558011_45501,1,78341,78341,108996,30655,30655,542,0,0,0
109006,application_1511916184019_3441,1,104482,104482,109006,4524,4524,129,0,0,0
109051,application_1511916184019_2654,1,102406,102406,109051,6645,6645,63,0,0,0
109051,application_1512440382012_0726,1,106288,106288,109051,2763,2763,90,0,0,0
109051,application_1506638472019_30274,1,30946,30946,109051,78105,78105,2048,0,0,0
109051,application_1508364558011_33826,1,69692,69692,109051,39359,39359,837,0,0,0
109061,application_1508364558011_13925,1,44826,44826,109061,64235,64235,1217,0,0,0
109081,application_1508364558011_24412,1,56908,56908,109081,52173,52173,1292,0,0,0
109091,application_1508364558011_26104,1,58476,58476,109091,50615,50615,1083,0,0,0
109136,application_1508364558011_43979,1,77932,77932,109136,31204,31204,688,0,0,0
109164,application_1508364558011_4681,1,39803,39803,109164,69361,69361,1759,0,0,0
109184,application_1511916184019_3413,1,104430,104430,109184,4754,4754,131,0,0,0
109235,application_1512440382012_0980,1,106657,106657,109235,2578,2578,81,0,0,0
109245,application_1506638472019_5042,1,15813,15813,109245,93432,93432,3086,0,0,0
109245,application_1508364558011_34524,1,69781,69781,109245,39464,39464,1422,0,0,0
109255,application_1512440382012_0037,1,105254,105254,109255,4001,4001,100,0,0,0
109275,application_1506638472019_16864,1,23305,23305,109275,85970,85970,2750,0,0,0
109337,application_1508364558011_7810,1,41527,41527,109337,67810,67810,1595,0,0,0
109347,application_1511916184019_3524,1,104576,104576,109347,4771,4771,65,0,0,0
109357,application_1511916184019_3291,1,104266,104266,109357,5091,5091,106,0,0,0
109387,application_1506638472019_17969,1,24509,24509,109387,84878,84878,2203,0,0,0
109407,application_1508364558011_7154,1,41278,41278,109407,68129,68129,1533,0,0,0
109407,application_1512440382012_0043,1,105255,105255,109407,4152,4152,112,0,0,0
109407,application_1512440382012_1132,1,106926,106926,109407,2481,2481,64,0,0,0
109421,application_1508364558011_5033,1,39860,39860,109421,69561,69561,1792,0,0,0
109431,application_1511916184019_2964,1,103806,103806,109431,5625,5625,68,0,0,0
109431,application_1511916184019_3364,1,104405,104405,109431,5026,5026,99,0,0,0
109445,application_1506638472019_21448,1,26292,26292,109445,83153,83153,2578,0,0,0
109445,application_1512440382012_0059,1,105255,105255,109445,4190,4190,105,0,0,0
109465,application_1506638472019_30201,1,30938,30938,109465,78527,78527,1980,0,0,0
109465,application_1508364558011_5765,1,40041,40041,109465,69424,69424,1478,0,0,0
109475,application_1511916184019_3419,1,104441,104441,109475,5034,5034,136,0,0,0
109475,application_1508364558011_43543,1,77893,77893,109475,31582,31582,630,0,0,0
109475,application_1506638472019_20006,1,25109,25109,109475,84366,84366,1864,0,0,0
109485,application_1508364558011_12534,1,43584,43584,109485,65901,65901,1969,0,0,0
109495,application_1506638472019_30236,1,30941,30941,109495,78554,78554,1991,0,0,0
109516,application_1512440382012_2655,1,109407,109407,109516,109,109,23,0,0,0
109516,application_1512440382012_0317,1,105582,105582,109516,3934,3934,95,0,0,0
109526,application_1508364558011_13493,1,44657,44657,109526,64869,64869,1295,0,0,0
109536,application_1506638472019_38584,1,36358,36358,109536,73178,73178,2400,0,0,0
109536,application_1506638472019_21613,1,26309,26309,109536,83227,83227,2148,0,0,0
109536,application_1506638472019_17936,1,24506,24506,109536,85030,85030,2111,0,0,0
109556,application_1512440382012_0816,1,106455,106455,109556,3101,3101,47,0,0,0
109556,application_1508364558011_9752,1,42137,42137,109556,67419,67419,1468,0,0,0
109568,application_1508364558011_7258,1,41279,41279,109568,68289,68289,1346,0,0,0
109580,application_1512440382012_1340,1,107361,107361,109580,2219,2219,28,0,0,0
109594,application_1506638472019_3369,1,13425,13425,109594,96169,96169,3605,0,0,0
109611,application_1511916184019_3376,1,104406,104406,109611,5205,5205,144,0,0,0
109627,application_1508364558011_15267,1,45568,45568,109627,64059,64059,1392,0,0,0
109642,application_1506638472019_7726,1,17251,17251,109642,92391,92391,2691,0,0,0
109645,application_1512440382012_0790,1,106400,106400,109645,3245,3245,56,0,0,0
109665,application_1508364558011_37437,1,72304,72304,109665,37361,37361,581,0,0,0
109685,application_1508364558011_6570,1,40812,40812,109685,68873,68873,1883,0,0,0
109690,application_1508364558011_14370,1,45001,45001,109690,64689,64689,1321,0,0,0
109693,application_1512440382012_1356,1,107406,107406,109693,2287,2287,68,0,0,0
109753,application_1506638472019_16190,1,23093,23093,109753,86660,86660,2720,0,0,0
109762,application_1512440382012_1293,1,107226,107226,109762,2536,2536,66,0,0,0
109773,application_1508364558011_11241,1,43016,43016,109773,66757,66757,1302,0,0,0
109797,application_1511916184019_2657,1,102426,102426,109797,7371,7371,69,0,0,0
109797,application_1506638472019_9049,1,17575,17575,109797,92222,92222,2804,0,0,0
109797,application_1508364558011_7761,1,41524,41524,109797,68273,68273,1236,0,0,0
109948,application_1511916184019_2777,1,102836,102836,109948,7112,7112,77,0,0,0
109961,application_1508364558011_14752,1,45315,45315,109961,64646,64646,1390,0,0,0
109986,application_1511916184019_3459,1,104483,104483,109986,5503,5503,106,0,0,0
110003,application_1512440382012_0134,1,105326,105326,110003,4677,4677,63,0,0,0
110032,application_1508364558011_42308,1,76208,76208,110032,33824,33824,655,0,0,0
110042,application_1508364558011_8040,1,41622,41622,110042,68420,68420,1582,0,0,0
110052,application_1508364558011_4731,1,39804,39804,110052,70248,70248,1370,0,0,0
110052,application_1506638472019_18482,1,24600,24600,110052,85452,85452,2201,0,0,0
110052,application_1506638472019_30320,1,30951,30951,110052,79101,79101,1990,0,0,0
110077,application_1511916184019_3201,1,104166,104166,110077,5911,5911,71,0,0,0
110087,application_1508364558011_39386,1,73645,73645,110087,36442,36442,825,0,0,0
110087,application_1512440382012_2759,4,109556,109556,110087,531,531,39,0,0,0
110125,application_1508364558011_1898,1,38853,38853,110125,71272,71272,1547,0,0,0
110125,application_1508364558011_8875,1,41849,41849,110125,68276,68276,1407,0,0,0
110125,application_1506638472019_14641,2,21624,21624,110125,88501,88501,9363,0,0,0
110135,application_1508364558011_37546,1,72312,72312,110135,37823,37823,902,0,0,0
110181,application_1506638472019_9175,1,17592,17592,110181,92589,92589,2726,0,0,0
110196,application_1511916184019_3349,1,104405,104405,110196,5791,5791,145,0,0,0
110216,application_1508364558011_33662,1,69538,69538,110216,40678,40678,830,0,0,0
110226,application_1512440382012_2011,1,108466,108466,110226,1760,1760,61,0,0,0
110226,application_1506638472019_17940,1,24506,24506,110226,85720,85720,2138,0,0,0
110236,application_1506638472019_17959,1,24508,24508,110236,85728,85728,2115,0,0,0
110266,application_1512440382012_1254,1,107126,107126,110266,3140,3140,63,0,0,0
110276,application_1512440382012_0033,1,105254,105254,110276,5022,5022,123,0,0,0
110296,application_1512440382012_0448,1,105856,105856,110296,4440,4440,76,0,0,0
110296,application_1508364558011_8287,1,41626,41626,110296,68670,68670,1358,0,0,0
110296,application_1508364558011_16335,1,46503,46503,110296,63793,63793,1359,0,0,0
110316,application_1511916184019_3305,1,104280,104280,110316,6036,6036,142,0,0,0
110326,application_1506638472019_6113,1,16621,16621,110326,93705,93705,3312,0,0,0
110326,application_1512440382012_0554,1,106106,106106,110326,4220,4220,65,0,0,0
110333,application_1506638472019_7642,1,17239,17239,110333,93094,93094,2658,0,0,0
110353,application_1506638472019_19608,1,24928,24928,110353,85425,85425,1874,0,0,0
110353,application_1512440382012_1342,1,107366,107366,110353,2987,2987,60,0,0,0
110373,application_1512440382012_1974,1,108376,108376,110373,1997,1997,53,0,0,0
110383,application_1511916184019_3479,1,104483,104483,110383,5900,5900,105,0,0,0
110393,application_1512440382012_1562,1,107896,107896,110393,2497,2497,65,0,0,0
110403,application_1512440382012_1286,1,107206,107206,110403,3197,3197,67,0,0,0
110403,application_1512440382012_0101,1,105266,105266,110403,5137,5137,80,0,0,0
110403,application_1511916184019_2452,1,101486,101486,110403,8917,8917,68,0,0,0
110416,application_1512440382012_1592,1,107936,107936,110416,2480,2480,60,0,0,0
110416,application_1506638472019_5589,1,15899,15899,110416,94517,94517,3850,0,0,0
110437,application_1508364558011_45479,1,78339,78339,110437,32098,32098,573,0,0,0
110437,application_1512440382012_2662,1,109411,109411,110437,1026,1026,12,0,0,0
110437,application_1511916184019_3496,1,104484,104484,110437,5953,5953,110,0,0,0
110454,application_1508364558011_12568,1,43585,43585,110454,66869,66869,1429,0,0,0
110457,application_1506638472019_18319,1,24572,24572,110457,85885,85885,2150,0,0,0
110477,application_1508364558011_11143,1,42997,42997,110477,67480,67480,1278,0,0,0
110477,application_1508364558011_16827,4,46828,46828,110477,63649,63649,326,0,0,0
110487,application_1506638472019_30577,1,30999,30999,110487,79488,79488,1996,0,0,0
110497,application_1508364558011_34386,1,69774,69774,110497,40723,40723,757,0,0,0
110497,application_1512440382012_1395,1,107516,107516,110497,2981,2981,64,0,0,0
110507,application_1512440382012_1596,1,107956,107956,110507,2551,2551,57,0,0,0
110507,application_1508364558011_2134,1,38994,38994,110507,71513,71513,1894,0,0,0
110517,application_1508364558011_8933,1,41850,41850,110517,68667,68667,2074,0,0,0
110537,application_1506638472019_30610,1,31002,31002,110537,79535,79535,1946,0,0,0
110557,application_1512440382012_1991,1,108436,108436,110557,2121,2121,64,0,0,0
110597,application_1508364558011_10411,1,42150,42150,110597,68447,68447,1490,0,0,0
110597,application_1506638472019_5041,1,15813,15813,110597,94784,94784,3596,0,0,0
110627,application_1508364558011_19318,1,48769,48769,110627,61858,61858,1327,0,0,0
110627,application_1506638472019_18700,1,24624,24624,110627,86003,86003,2103,0,0,0
110660,application_1508364558011_3818,1,39290,39290,110660,71370,71370,1990,0,0,0
110660,application_1506638472019_22820,1,26994,26994,110660,83666,83666,2584,0,0,0
110660,application_1511916184019_0368,2,97197,97197,110660,13463,13463,16,0,0,0
110670,application_1506638472019_25143,1,27791,27791,110670,82879,82879,3322,0,0,0
110680,application_1512440382012_0038,1,105254,105254,110680,5426,5426,120,0,0,0
110680,application_1511916184019_0429,2,97493,97493,110680,13187,13187,20,0,0,0
110690,application_1508364558011_25298,1,57449,57449,110690,53241,53241,1029,0,0,0
110704,application_1511916184019_0746,2,98049,98049,110704,12655,12655,24,0,0,0
110724,application_1508364558011_17487,1,47490,47490,110724,63234,63234,1791,0,0,0
110734,application_1511916184019_0833,2,98251,98251,110734,12483,12483,22,0,0,0
110744,application_1511916184019_3283,1,104261,104261,110744,6483,6483,114,0,0,0
110754,application_1508364558011_4859,1,39809,39809,110754,70945,70945,1507,0,0,0
110754,application_1506638472019_8862,1,17548,17548,110754,93206,93206,2659,0,0,0
110766,application_1511916184019_0878,2,98326,98326,110766,12440,12440,27,0,0,0
110776,application_1506638472019_16975,1,23324,23324,110776,87452,87452,2646,0,0,0
110784,application_1506638472019_28694,1,29211,29211,110784,81573,81573,2364,0,0,0
110784,application_1512440382012_1327,1,107346,107346,110784,3438,3438,110,0,0,0
110794,application_1508364558011_8398,1,41641,41641,110794,69153,69153,1808,0,0,0
110834,application_1511916184019_2949,1,103786,103786,110834,7048,7048,113,0,0,0
110854,application_1512440382012_2477,1,109081,109081,110854,1773,1773,39,0,0,0
110864,application_1508364558011_35160,1,69884,69884,110864,40980,40980,1614,0,0,0
110874,application_1508364558011_22889,1,54792,54792,110874,56082,56082,968,0,0,0
110884,application_1506638472019_21639,1,26311,26311,110884,84573,84573,2369,0,0,0
110884,application_1512440382012_1289,1,107216,107216,110884,3668,3668,60,0,0,0
110894,application_1508364558011_39196,1,73629,73629,110894,37265,37265,734,0,0,0
110905,application_1511916184019_3460,1,104483,104483,110905,6422,6422,106,0,0,0
110925,application_1508364558011_5228,1,39865,39865,110925,71060,71060,1564,0,0,0
110946,application_1506638472019_30436,1,30963,30963,110946,79983,79983,1950,0,0,0
110946,application_1508364558011_11238,1,43015,43015,110946,67931,67931,1277,0,0,0
110946,application_1506638472019_17440,1,23828,23828,110946,87118,87118,2309,0,0,0
110956,application_1511916184019_3439,1,104482,104482,110956,6474,6474,150,0,0,0
110976,application_1511916184019_2801,1,102981,102981,110976,7995,7995,169,0,0,0
110976,application_1508364558011_19418,1,48803,48803,110976,62173,62173,1358,0,0,0
110986,application_1511916184019_3297,1,104268,104268,110986,6718,6718,142,0,0,0
111016,application_1506638472019_9114,1,17585,17585,111016,93431,93431,2635,0,0,0
111046,application_1506638472019_19955,1,25054,25054,111046,85992,85992,1847,0,0,0
111056,application_1506638472019_2013,4,11433,11433,111056,99623,99623,3999,0,0,0
111066,application_1506638472019_28367,1,29149,29149,111066,81917,81917,2335,0,0,0
111076,application_1508364558011_19868,1,49208,49208,111076,61868,61868,1147,0,0,0
111106,application_1512440382012_2072,1,108616,108616,111106,2490,2490,85,0,0,0
111136,application_1508364558011_8508,1,41643,41643,111136,69493,69493,1363,0,0,0
111176,application_1512440382012_2159,1,108673,108673,111176,2503,2503,101,0,0,0
111176,application_1512440382012_1531,1,107846,107846,111176,3330,3330,72,0,0,0
111206,application_1508364558011_20810,1,50147,50147,111206,61059,61059,1316,0,0,0
111226,application_1508364558011_17319,1,47396,47396,111226,63830,63830,1281,0,0,0
111226,application_1508364558011_20925,1,50264,50264,111226,60962,60962,1367,0,0,0
111236,application_1512440382012_2102,1,108646,108646,111236,2590,2590,86,0,0,0
111236,application_1508364558011_2456,1,39014,39014,111236,72222,72222,1475,0,0,0
111278,application_1508364558011_36429,1,70703,70703,111278,40575,40575,778,0,0,0
111288,application_1511916184019_1539,1,99577,99577,111288,11711,11711,301,0,0,0
111298,application_1508364558011_9857,1,42138,42138,111298,69160,69160,1415,0,0,0
111308,application_1508364558011_1894,1,38852,38852,111308,72456,72456,1608,0,0,0
111318,application_1508364558011_36447,8,70720,70720,111318,40598,40598,453,0,0,0
111328,application_1508364558011_9308,1,42061,42061,111328,69267,69267,1502,0,0,0
111338,application_1508364558011_1914,1,38853,38853,111338,72485,72485,1956,0,0,0
111338,application_1506638472019_30426,1,30962,30962,111338,80376,80376,2059,0,0,0
111366,application_1508364558011_34314,1,69768,69768,111366,41598,41598,811,0,0,0
111376,application_1506638472019_37027,1,35534,35534,111376,75842,75842,1842,0,0,0
111386,application_1508364558011_20089,1,49260,49260,111386,62126,62126,1376,0,0,0
111386,application_1512440382012_1667,1,108127,108127,111386,3259,3259,49,0,0,0
111426,application_1508364558011_19421,1,48803,48803,111426,62623,62623,1133,0,0,0
111436,application_1512440382012_2523,1,109154,109154,111436,2282,2282,62,0,0,0
111446,application_1508364558011_39533,1,73749,73749,111446,37697,37697,750,0,0,0
111466,application_1506638472019_18077,1,24520,24520,111466,86946,86946,2169,0,0,0
111466,application_1508364558011_34337,1,69770,69770,111466,41696,41696,895,0,0,0
111496,application_1506638472019_30715,1,31017,31017,111496,80479,80479,1964,0,0,0
111526,application_1512440382012_0090,1,105257,105257,111526,6269,6269,137,0,0,0
111546,application_1508364558011_16526,1,46570,46570,111546,64976,64976,1551,0,0,0
111600,application_1512440382012_4939,1,110105,110105,111600,1495,1495,76,0,0,0
111616,application_1508364558011_3322,1,39220,39220,111616,72396,72396,1756,0,0,0
111626,application_1506638472019_12173,1,18823,18823,111626,92803,92803,3037,0,0,0
111626,application_1511916184019_1943,2,100308,100308,111626,11318,11318,22,0,0,0
111646,application_1511916184019_1959,2,100373,100373,111646,11273,11273,15,0,0,0
111706,application_1512440382012_2714,1,109496,109496,111706,2210,2210,55,0,0,0
111706,application_1512440382012_4967,1,110196,110196,111706,1510,1510,71,0,0,0
111716,application_1512440382012_1819,1,108286,108286,111716,3430,3430,59,0,0,0
111716,application_1508364558011_39835,1,73775,73775,111716,37941,37941,883,0,0,0
111726,application_1508364558011_44410,1,78154,78154,111726,33572,33572,534,0,0,0
111726,application_1508364558011_45437,1,78333,78333,111726,33393,33393,574,0,0,0
111736,application_1508364558011_4247,1,39363,39363,111736,72373,72373,1352,0,0,0
111736,application_1506638472019_5637,1,15900,15900,111736,95836,95836,3459,0,0,0
111746,application_1512440382012_3571,1,109706,109706,111746,2040,2040,60,0,0,0
111776,application_1508364558011_9182,1,41854,41854,111776,69922,69922,1544,0,0,0
111796,application_1508364558011_5122,1,39862,39862,111796,71934,71934,1299,0,0,0
111796,application_1506638472019_17444,1,23830,23830,111796,87966,87966,2250,0,0,0
111796,application_1512440382012_1209,1,107046,107046,111796,4750,4750,68,0,0,0
111806,application_1512440382012_1622,1,108026,108026,111806,3780,3780,60,0,0,0
111806,application_1506638472019_17947,1,24507,24507,111806,87299,87299,2068,0,0,0
111826,application_1512440382012_2372,1,108939,108939,111826,2887,2887,67,0,0,0
111846,application_1506638472019_22868,1,26999,26999,111846,84847,84847,2519,0,0,0
111846,application_1508364558011_36442,1,70716,70716,111846,41130,41130,816,0,0,0
111856,application_1506638472019_30170,1,30934,30934,111856,80922,80922,2004,0,0,0
111866,application_1511916184019_1766,1,99826,99826,111866,12040,12040,168,0,0,0
111876,application_1506638472019_26332,1,28339,28339,111876,83537,83537,2252,0,0,0
111876,application_1512440382012_2327,1,108916,108916,111876,2960,2960,69,0,0,0
111946,application_1508364558011_7296,1,41280,41280,111946,70666,70666,1529,0,0,0
111946,application_1508364558011_24387,1,56905,56905,111946,55041,55041,1346,0,0,0
111995,application_1506638472019_30381,1,30957,30957,111995,81038,81038,1944,0,0,0
112006,application_1508364558011_6512,1,40811,40811,112006,71195,71195,1749,0,0,0
112006,application_1512440382012_2184,1,108676,108676,112006,3330,3330,59,0,0,0
112016,application_1512440382012_1814,1,108280,108280,112016,3736,3736,83,0,0,0
112036,application_1508364558011_50368,1,87045,87045,112036,24991,24991,426,0,0,0
112046,application_1506638472019_19097,1,24825,24825,112046,87221,87221,1965,0,0,0
112066,application_1508364558011_19694,1,49113,49113,112066,62953,62953,1436,0,0,0
112066,application_1506638472019_16330,1,23123,23123,112066,88943,88943,2825,0,0,0
112076,application_1512440382012_2464,1,109066,109066,112076,3010,3010,57,0,0,0
112086,application_1506638472019_24551,1,27702,27702,112086,84384,84384,2653,0,0,0
112096,application_1512440382012_3701,1,109763,109763,112096,2333,2333,17,0,0,0
112116,application_1511916184019_2189,1,100841,100841,112116,11275,11275,189,0,0,0
112156,application_1506638472019_16849,1,23302,23302,112156,88854,88854,2657,0,0,0
112166,application_1508364558011_30165,8,66402,66402,112166,45764,45764,228,0,0,0
112186,application_1506638472019_9068,1,17578,17578,112186,94608,94608,2625,0,0,0
112186,application_1512440382012_2077,1,108636,108636,112186,3550,3550,83,0,0,0
112186,application_1512440382012_2095,1,108644,108644,112186,3542,3542,77,0,0,0
112196,application_1506638472019_6921,1,17148,17148,112196,95048,95048,2688,0,0,0
112226,application_1508364558011_39901,1,73781,73781,112226,38445,38445,819,0,0,0
112226,application_1506638472019_39065,1,37057,37057,112226,75169,75169,1584,0,0,0
112266,application_1512440382012_4954,1,110166,110166,112266,2100,2100,70,0,0,0
112276,application_1508364558011_16147,1,46392,46392,112276,65884,65884,1253,0,0,0
112276,application_1508364558011_3920,1,39297,39297,112276,72979,72979,1531,0,0,0
112286,application_1508364558011_6463,1,40810,40810,112286,71476,71476,1589,0,0,0
112286,application_1512440382012_2096,1,108644,108644,112286,3642,3642,82,0,0,0
112296,application_1512440382012_2449,1,109041,109041,112296,3255,3255,90,0,0,0
112296,application_1512440382012_2152,1,108669,108669,112296,3627,3627,94,0,0,0
112305,application_1512440382012_2151,1,108669,108669,112305,3636,3636,104,0,0,0
112314,application_1506638472019_30990,1,31046,31046,112314,81268,81268,2030,0,0,0
112324,application_1506638472019_19548,1,24919,24919,112324,87405,87405,2088,0,0,0
112324,application_1508364558011_10070,1,42144,42144,112324,70180,70180,2131,0,0,0
112334,application_1506638472019_32957,1,33674,33674,112334,78660,78660,1677,0,0,0
112334,application_1512440382012_2353,1,108938,108938,112334,3396,3396,70,0,0,0
112346,application_1506638472019_39106,1,37059,37059,112346,75287,75287,1617,0,0,0
112356,application_1508364558011_39787,1,73770,73770,112356,38586,38586,656,0,0,0
112386,application_1512440382012_1635,1,108056,108056,112386,4330,4330,62,0,0,0
112406,application_1512440382012_2089,1,108643,108643,112406,3763,3763,81,0,0,0
112426,application_1512440382012_2087,1,108643,108643,112426,3783,3783,81,0,0,0
112426,application_1506638472019_18169,1,24539,24539,112426,87887,87887,2098,0,0,0
112436,application_1508364558011_32753,1,69005,69005,112436,43431,43431,774,0,0,0
112436,application_1506638472019_21924,1,26343,26343,112436,86093,86093,2523,0,0,0
112446,application_1506638472019_27826,1,29046,29046,112446,83400,83400,2371,0,0,0
112456,application_1506638472019_27881,1,29054,29054,112456,83402,83402,2374,0,0,0
112466,application_1506638472019_25621,1,27858,27858,112466,84608,84608,2737,0,0,0
112476,application_1508364558011_18797,1,48067,48067,112476,64409,64409,1401,0,0,0
112486,application_1508364558011_6803,1,40815,40815,112486,71671,71671,1540,0,0,0
112516,application_1508364558011_40724,1,74334,74334,112516,38182,38182,762,0,0,0
112516,application_1512440382012_5516,1,110895,110895,112516,1621,1621,80,0,0,0
112526,application_1512440382012_2384,1,108940,108940,112526,3586,3586,81,0,0,0
112536,application_1506638472019_28003,1,29073,29073,112536,83463,83463,2384,0,0,0
112546,application_1506638472019_19108,1,24827,24827,112546,87719,87719,1855,0,0,0
112546,application_1508364558011_16365,1,46505,46505,112546,66041,66041,1456,0,0,0
112556,application_1512440382012_2119,1,108663,108663,112556,3893,3893,122,0,0,0
112576,application_1508364558011_10557,1,42167,42167,112576,70409,70409,1187,0,0,0
112616,application_1506638472019_30504,1,30970,30970,112616,81646,81646,2034,0,0,0
112646,application_1506638472019_30717,1,31017,31017,112646,81629,81629,2026,0,0,0
112646,application_1506638472019_30859,1,31032,31032,112646,81614,81614,1955,0,0,0
112656,application_1506638472019_18118,1,24535,24535,112656,88121,88121,2104,0,0,0
112656,application_1508364558011_15145,1,45566,45566,112656,67090,67090,1392,0,0,0
112666,application_1512440382012_2120,1,108663,108663,112666,4003,4003,104,0,0,0
112676,application_1508364558011_12563,1,43585,43585,112676,69091,69091,1460,0,0,0
112686,application_1508364558011_48671,1,84629,84629,112686,28057,28057,399,0,0,0
112696,application_1512440382012_2157,1,108671,108671,112696,4025,4025,96,0,0,0
112706,application_1506638472019_16289,1,23113,23113,112706,89593,89593,2728,0,0,0
112706,application_1508364558011_3388,1,39228,39228,112706,73478,73478,2114,0,0,0
112716,application_1512440382012_1322,1,107334,107334,112716,5382,5382,74,0,0,0
112736,application_1508364558011_5866,1,40042,40042,112736,72694,72694,1350,0,0,0
112746,application_1508364558011_39448,1,73651,73651,112746,39095,39095,895,0,0,0
112776,application_1512440382012_2388,1,108940,108940,112776,3836,3836,83,0,0,0
112776,application_1512440382012_5570,1,111006,111006,112776,1770,1770,59,0,0,0
112776,application_1508364558011_39527,1,73749,73749,112776,39027,39027,746,0,0,0
112796,application_1506638472019_2620,1,13293,13293,112796,99503,99503,3650,0,0,0
112816,application_1508364558011_39993,1,73790,73790,112816,39026,39026,748,0,0,0
112816,application_1508364558011_6593,1,40812,40812,112816,72004,72004,1719,0,0,0
112816,application_1508364558011_43937,1,77928,77928,112816,34888,34888,588,0,0,0
112846,application_1512440382012_4552,1,109986,109986,112846,2860,2860,70,0,0,0
112846,application_1512440382012_2720,1,109506,109506,112846,3340,3340,64,0,0,0
112856,application_1512440382012_2418,1,108976,108976,112856,3880,3880,69,0,0,0
112866,application_1506638472019_31165,1,31200,31200,112866,81666,81666,2068,0,0,0
112896,application_1512440382012_5602,1,111156,111156,112896,1740,1740,66,0,0,0
112946,application_1511916184019_3469,1,104483,104483,112946,8463,8463,151,0,0,0
113016,application_1506638472019_30298,1,30948,30948,113016,82068,82068,2123,0,0,0
113036,application_1512440382012_0687,1,106233,106233,113036,6803,6803,200,0,0,0
113046,application_1508364558011_39436,1,73650,73650,113046,39396,39396,908,0,0,0
113066,application_1508364558011_8457,1,41642,41642,113066,71424,71424,1490,0,0,0
113076,application_1512440382012_5535,1,110936,110936,113076,2140,2140,68,0,0,0
113096,application_1512440382012_0081,1,105256,105256,113096,7840,7840,123,0,0,0
113106,application_1506638472019_18497,1,24601,24601,113106,88505,88505,2156,0,0,0
113116,application_1506638472019_30161,1,30933,30933,113116,82183,82183,1949,0,0,0
113216,application_1512440382012_0907,1,106561,106561,113216,6655,6655,134,0,0,0
113246,application_1508364558011_40196,1,73808,73808,113246,39438,39438,731,0,0,0
113266,application_1508364558011_20745,1,50009,50009,113266,63257,63257,1453,0,0,0
113266,application_1508364558011_24616,1,57287,57287,113266,55979,55979,1404,0,0,0
113276,application_1508364558011_25863,1,57936,57936,113276,55340,55340,1027,0,0,0
113286,application_1511916184019_0496,1,97640,97640,113286,15646,15646,250,0,0,0
113286,application_1512440382012_2173,1,108673,108673,113286,4613,4613,127,0,0,0
113296,application_1508364558011_39692,1,73763,73763,113296,39533,39533,745,0,0,0
113306,application_1508364558011_9626,1,42067,42067,113306,71239,71239,1751,0,0,0
113326,application_1508364558011_10540,1,42166,42166,113326,71160,71160,1462,0,0,0
113356,application_1508364558011_2381,1,39006,39006,113356,74350,74350,1813,0,0,0
113356,application_1508364558011_5592,1,40037,40037,113356,73319,73319,1562,0,0,0
113366,application_1508364558011_37393,1,72300,72300,113366,41066,41066,899,0,0,0
113366,application_1506638472019_7737,1,17253,17253,113366,96113,96113,2686,0,0,0
113396,application_1512440382012_5194,1,110516,110516,113396,2880,2880,74,0,0,0
113426,application_1508364558011_34937,1,69868,69868,113426,43558,43558,768,0,0,0
113436,application_1512440382012_4694,1,110018,110018,113436,3418,3418,116,0,0,0
113446,application_1508364558011_7213,1,41279,41279,113446,72167,72167,2065,0,0,0
113486,application_1512440382012_3956,1,109846,109846,113486,3640,3640,63,0,0,0
113486,application_1506638472019_28007,1,29074,29074,113486,84412,84412,2325,0,0,0
113496,application_1512440382012_5692,1,111606,111606,113496,1890,1890,69,0,0,0
113496,application_1508364558011_45465,1,78337,78337,113496,35159,35159,618,0,0,0
113566,application_1506638472019_25372,1,27830,27830,113566,85736,85736,2730,0,0,0
113586,application_1508364558011_19673,1,49112,49112,113586,64474,64474,1507,0,0,0
113586,application_1512440382012_5854,1,112456,112456,113586,1130,1130,69,0,0,0
113596,application_1506638472019_31209,1,31208,31208,113596,82388,82388,1984,0,0,0
113626,application_1508364558011_18957,1,48247,48247,113626,65379,65379,1192,0,0,0
113636,application_1511916184019_1681,1,99760,99760,113636,13876,13876,333,0,0,0
113656,application_1512440382012_4981,1,110256,110256,113656,3400,3400,69,0,0,0
113666,application_1511916184019_1462,1,99562,99562,113666,14104,14104,304,0,0,0
113666,application_1511916184019_1506,1,99570,99570,113666,14096,14096,308,0,0,0
113686,application_1512440382012_2472,1,109077,109077,113686,4609,4609,80,0,0,0
113736,application_1512440382012_5648,1,111366,111366,113736,2370,2370,68,0,0,0
113746,application_1512440382012_5669,1,111466,111466,113746,2280,2280,79,0,0,0
113786,application_1508364558011_12557,1,43585,43585,113786,70201,70201,1406,0,0,0
113806,application_1512440382012_4693,1,110018,110018,113806,3788,3788,118,0,0,0
113836,application_1506638472019_22752,1,26981,26981,113836,86855,86855,1977,0,0,0
113836,application_1506638472019_22418,1,26565,26565,113836,87271,87271,2569,0,0,0
113846,application_1508364558011_46184,1,79152,79152,113846,34694,34694,786,0,0,0
113866,application_1506638472019_27829,1,29046,29046,113866,84820,84820,2389,0,0,0
113866,application_1508364558011_49935,1,86387,86387,113866,27479,27479,667,0,0,0
113886,application_1508364558011_49854,1,86377,86377,113886,27509,27509,622,0,0,0
113886,application_1512440382012_5603,1,111156,111156,113886,2730,2730,76,0,0,0
113896,application_1512440382012_0285,1,105560,105560,113896,8336,8336,288,0,0,0
113935,application_1512440382012_2074,1,108626,108626,113935,5309,5309,77,0,0,0
113955,application_1512440382012_5827,1,112336,112336,113955,1619,1619,57,0,0,0
113965,application_1506638472019_21857,1,26335,26335,113965,87630,87630,2597,0,0,0
113965,application_1512440382012_2246,1,108747,108747,113965,5218,5218,180,0,0,0
113965,application_1506638472019_30367,1,30956,30956,113965,83009,83009,2037,0,0,0
113965,application_1508364558011_15097,1,45565,45565,113965,68400,68400,1785,0,0,0
113975,application_1508364558011_7047,1,41189,41189,113975,72786,72786,1713,0,0,0
113985,application_1512440382012_5747,1,111946,111946,113985,2039,2039,60,0,0,0
113985,application_1512440382012_3068,1,109618,109618,113985,4367,4367,76,0,0,0
114025,application_1506638472019_18640,1,24618,24618,114025,89407,89407,2096,0,0,0
114025,application_1506638472019_24240,1,27373,27373,114025,86652,86652,2735,0,0,0
114035,application_1506638472019_16872,1,23307,23307,114035,90728,90728,2742,0,0,0
114045,application_1508364558011_9584,1,42067,42067,114045,71978,71978,1578,0,0,0
114045,application_1506638472019_22872,1,27000,27000,114045,87045,87045,2549,0,0,0
114055,application_1508364558011_41656,1,75237,75237,114055,38818,38818,1497,0,0,0
114065,application_1506638472019_30546,1,30995,30995,114065,83070,83070,2020,0,0,0
114065,application_1506638472019_30227,1,30940,30940,114065,83125,83125,1964,0,0,0
114075,application_1508364558011_4638,1,39802,39802,114075,74273,74273,1616,0,0,0
114085,application_1506638472019_16280,1,23112,23112,114085,90973,90973,2706,0,0,0
114120,application_1512440382012_4980,1,110246,110246,114120,3874,3874,79,0,0,0
114120,application_1506638472019_30751,1,31021,31021,114120,83099,83099,2011,0,0,0
114120,application_1512440382012_5774,1,112126,112126,114120,1994,1994,70,0,0,0
114141,application_1512440382012_4698,1,110018,110018,114141,4123,4123,116,0,0,0
114141,application_1508364558011_31988,1,68416,68416,114141,45725,45725,1599,0,0,0
114144,application_1512440382012_2130,1,108666,108666,114144,5478,5478,137,0,0,0
114154,application_1511916184019_1998,2,100456,100456,114154,13698,13698,34,0,0,0
114184,application_1511916184019_1999,2,100456,100456,114184,13728,13728,27,0,0,0
114244,application_1508364558011_5093,1,39861,39861,114244,74383,74383,2163,0,0,0
114284,application_1512440382012_4977,1,110236,110236,114284,4048,4048,77,0,0,0
114316,application_1506638472019_8884,1,17552,17552,114316,96764,96764,2570,0,0,0
114316,application_1508364558011_1892,1,38852,38852,114316,75464,75464,1354,0,0,0
114371,application_1506638472019_30059,1,30921,30921,114371,83450,83450,1973,0,0,0
114421,application_1508364558011_9279,1,42060,42060,114421,72361,72361,1569,0,0,0
114431,application_1512440382012_0675,1,106221,106221,114431,8210,8210,127,0,0,0
114451,application_1512440382012_5986,1,112976,112976,114451,1475,1475,58,0,0,0
114461,application_1508364558011_46314,1,79239,79239,114461,35222,35222,831,0,0,0
114491,application_1508364558011_20103,1,49260,49260,114491,65231,65231,1412,0,0,0
114491,application_1512440382012_5667,1,111456,111456,114491,3035,3035,70,0,0,0
114501,application_1506638472019_28803,1,29232,29232,114501,85269,85269,2306,0,0,0
114501,application_1511916184019_1680,1,99759,99759,114501,14742,14742,315,0,0,0
114511,application_1508364558011_10068,1,42144,42144,114511,72367,72367,1849,0,0,0
114511,application_1511916184019_1496,1,99567,99567,114511,14944,14944,310,0,0,0
114527,application_1512440382012_3192,1,109646,109646,114527,4881,4881,68,0,0,0
114537,application_1508364558011_5011,1,39860,39860,114537,74677,74677,1405,0,0,0
114547,application_1506638472019_6495,1,17073,17073,114547,97474,97474,2588,0,0,0
114547,application_1508364558011_37903,8,72780,72780,114547,41767,41767,237,0,0,0
114577,application_1506638472019_8899,1,17554,17554,114577,97023,97023,2736,0,0,0
114587,application_1512440382012_5664,1,111436,111436,114587,3151,3151,72,0,0,0
114587,application_1512440382012_5897,1,112666,112666,114587,1921,1921,75,0,0,0
114597,application_1508364558011_24951,1,57397,57397,114597,57200,57200,1295,0,0,0
114627,application_1508364558011_13819,1,44696,44696,114627,69931,69931,1323,0,0,0
114657,application_1506638472019_28732,1,29217,29217,114657,85440,85440,2278,0,0,0
114657,application_1506638472019_30645,1,31006,31006,114657,83651,83651,2037,0,0,0
114657,application_1506638472019_30755,1,31021,31021,114657,83636,83636,2014,0,0,0
114697,application_1508364558011_5326,1,39870,39870,114697,74827,74827,1684,0,0,0
114707,application_1511916184019_1730,1,99771,99771,114707,14936,14936,338,0,0,0
114707,application_1512440382012_4761,1,110022,110022,114707,4685,4685,175,0,0,0
114717,application_1512440382012_5544,1,110956,110956,114717,3761,3761,69,0,0,0
114717,application_1508364558011_3352,1,39225,39225,114717,75492,75492,1675,0,0,0
114727,application_1508364558011_11470,1,43294,43294,114727,71433,71433,1386,0,0,0
114737,application_1506638472019_5004,1,15812,15812,114737,98925,98925,3475,0,0,0
114737,application_1512440382012_4936,1,110093,110093,114737,4644,4644,103,0,0,0
114747,application_1512440382012_5572,1,111016,111016,114747,3731,3731,67,0,0,0
114806,application_1508364558011_39190,1,73628,73628,114806,41178,41178,823,0,0,0
114806,application_1512440382012_5764,1,112046,112046,114806,2760,2760,62,0,0,0
114844,application_1508364558011_20982,1,50266,50266,114844,64578,64578,1446,0,0,0
114867,application_1508364558011_34894,1,69864,69864,114867,45003,45003,799,0,0,0
114889,application_1512440382012_5884,1,112606,112606,114889,2283,2283,68,0,0,0
114913,application_1511916184019_2360,1,101324,101324,114913,13589,13589,328,0,0,0
114953,application_1506638472019_16577,1,23171,23171,114953,91782,91782,2984,0,0,0
114988,application_1512440382012_4703,1,110019,110019,114988,4969,4969,135,0,0,0
114988,application_1508364558011_3298,1,39219,39219,114988,75769,75769,1784,0,0,0
114988,application_1511916184019_2306,2,101193,101193,114988,13795,13795,20,0,0,0
115008,application_1508364558011_8916,1,41849,41849,115008,73159,73159,2518,0,0,0
115018,application_1508364558011_34061,1,69723,69723,115018,45295,45295,884,0,0,0
115018,application_1512440382012_5963,1,112866,112866,115018,2152,2152,65,0,0,0
115018,application_1511916184019_2440,2,101409,101409,115018,13609,13609,26,0,0,0
115038,application_1508364558011_36680,8,71111,71111,115038,43927,43927,418,0,0,0
115048,application_1506638472019_31022,1,31075,31075,115048,83973,83973,2000,0,0,0
115058,application_1511916184019_1432,1,99556,99556,115058,15502,15502,328,0,0,0
115068,application_1506638472019_7004,1,17153,17153,115068,97915,97915,2718,0,0,0
115068,application_1511916184019_2489,2,101638,101638,115068,13430,13430,50,0,0,0
115078,application_1506638472019_30707,1,31016,31016,115078,84062,84062,2036,0,0,0
115098,application_1506638472019_18441,1,24596,24596,115098,90502,90502,2135,0,0,0
115098,application_1511916184019_2527,2,101853,101853,115098,13245,13245,29,0,0,0
115113,application_1508364558011_19382,1,48800,48800,115113,66313,66313,1504,0,0,0
115133,application_1512440382012_5754,1,111996,111996,115133,3137,3137,62,0,0,0
115143,application_1508364558011_49917,1,86385,86385,115143,28758,28758,660,0,0,0
115163,application_1506638472019_22832,1,26996,26996,115163,88167,88167,2473,0,0,0
115173,application_1506638472019_23317,1,27180,27180,115173,87993,87993,2593,0,0,0
115175,application_1506638472019_5620,1,15900,15900,115175,99275,99275,3822,0,0,0
115205,application_1506638472019_17144,1,23357,23357,115205,91848,91848,2670,0,0,0
115219,application_1508364558011_20750,1,50009,50009,115219,65210,65210,1407,0,0,0
115229,application_1508364558011_12411,1,43574,43574,115229,71655,71655,1290,0,0,0
115239,application_1508364558011_42974,1,76953,76953,115239,38286,38286,794,0,0,0
115257,application_1511916184019_2347,1,101321,101321,115257,13936,13936,312,0,0,0
115286,application_1508364558011_49180,1,85247,85247,115286,30039,30039,875,0,0,0
115306,application_1506638472019_28738,1,29218,29218,115306,86088,86088,2341,0,0,0
115316,application_1512440382012_5748,1,111956,111956,115316,3360,3360,70,0,0,0
115343,application_1508364558011_11437,1,43293,43293,115343,72050,72050,1826,0,0,0
115358,application_1512440382012_6327,1,114108,114108,115358,1250,1250,68,0,0,0
115398,application_1512440382012_5583,1,111036,111036,115398,4362,4362,74,0,0,0
115418,application_1508364558011_4898,1,39810,39810,115418,75608,75608,2322,0,0,0
115427,application_1506638472019_18357,1,24582,24582,115427,90845,90845,2117,0,0,0
115427,application_1512440382012_4689,1,110017,110017,115427,5410,5410,209,0,0,0
115454,application_1506638472019_28549,1,29190,29190,115454,86264,86264,2512,0,0,0
115463,application_1508364558011_6530,1,40811,40811,115463,74652,74652,1761,0,0,0
115463,application_1512440382012_5768,1,112086,112086,115463,3377,3377,74,0,0,0
115483,application_1511916184019_0467,1,97578,97578,115483,17905,17905,249,0,0,0
115493,application_1508364558011_20432,1,49640,49640,115493,65853,65853,1462,0,0,0
115503,application_1506638472019_37001,1,35533,35533,115503,79970,79970,1802,0,0,0
115513,application_1513025660013_0008,1,114966,114966,115513,547,547,39,0,0,0
115523,application_1508364558011_5575,1,40037,40037,115523,75486,75486,1931,0,0,0
115523,application_1512440382012_4743,1,110021,110021,115523,5502,5502,174,0,0,0
115543,application_1512440382012_1548,1,107865,107865,115543,7678,7678,160,0,0,0
115595,application_1508364558011_8558,1,41644,41644,115595,73951,73951,1477,0,0,0
115605,application_1508364558011_9149,1,41853,41853,115605,73752,73752,1635,0,0,0
115605,application_1511916184019_1489,1,99566,99566,115605,16039,16039,321,0,0,0
115616,application_1512440382012_5853,1,112446,112446,115616,3170,3170,70,0,0,0
115626,application_1511916184019_2402,1,101334,101334,115626,14292,14292,321,0,0,0
115626,application_1512440382012_5892,1,112656,112656,115626,2970,2970,70,0,0,0
115653,application_1508364558011_39688,1,73762,73762,115653,41891,41891,880,0,0,0
115653,application_1508364558011_34220,1,69760,69760,115653,45893,45893,853,0,0,0
115665,application_1506638472019_28350,1,29146,29146,115665,86519,86519,2327,0,0,0
115677,application_1508364558011_5844,1,40042,40042,115677,75635,75635,1532,0,0,0
115687,application_1508364558011_6504,1,40811,40811,115687,74876,74876,1592,0,0,0
115697,application_1508364558011_7187,1,41278,41278,115697,74419,74419,1668,0,0,0
115697,application_1506638472019_9019,1,17571,17571,115697,98126,98126,2734,0,0,0
115707,application_1508364558011_42975,1,76953,76953,115707,38754,38754,785,0,0,0
115717,application_1508364558011_19410,1,48802,48802,115717,66915,66915,1465,0,0,0
115777,application_1508364558011_39285,1,73637,73637,115777,42140,42140,886,0,0,0
115866,application_1508364558011_40357,1,73899,73899,115866,41967,41967,1061,0,0,0
115876,application_1508364558011_20389,1,49637,49637,115876,66239,66239,2187,0,0,0
115926,application_1506638472019_10193,1,17964,17964,115926,97962,97962,3389,0,0,0
115975,application_1508364558011_20944,1,50265,50265,115975,65710,65710,1682,0,0,0
116054,application_1508364558011_20073,1,49259,49259,116054,66795,66795,1716,0,0,0
116072,application_1508364558011_8434,1,41641,41641,116072,74431,74431,1953,0,0,0
116072,application_1506638472019_38008,1,36089,36089,116072,79983,79983,2117,0,0,0
116102,application_1506638472019_8298,1,17384,17384,116102,98718,98718,3798,0,0,0
116112,application_1508364558011_8692,1,41646,41646,116112,74466,74466,1919,0,0,0
116196,application_1512440382012_2832,1,109588,109588,116196,6608,6608,650,0,0,0
116206,application_1508364558011_47308,1,80508,80508,116206,35698,35698,1035,0,0,0
116316,application_1508364558011_17486,1,47490,47490,116316,68826,68826,1946,0,0,0
116354,application_1508364558011_14418,1,45026,45026,116354,71328,71328,1468,0,0,0
116364,application_1512440382012_1782,1,108214,108214,116364,8150,8150,212,0,0,0
116364,application_1506638472019_5690,1,15902,15902,116364,100462,100462,3615,0,0,0
116374,application_1506638472019_21780,1,26327,26327,116374,90047,90047,2546,0,0,0
116394,application_1511916184019_2637,2,102298,102298,116394,14096,14096,45,0,0,0
116404,application_1513025660013_0323,1,115427,115427,116404,977,977,64,0,0,0
116416,application_1506638472019_30882,1,31034,31034,116416,85382,85382,1945,0,0,0
116426,application_1508364558011_6818,1,40816,40816,116426,75610,75610,1622,0,0,0
116436,application_1512440382012_4699,1,110019,110019,116436,6417,6417,215,0,0,0
116456,application_1511916184019_1726,1,99770,99770,116456,16686,16686,322,0,0,0
116476,application_1508364558011_29370,1,65900,65900,116476,50576,50576,1412,0,0,0
116506,application_1508364558011_8462,1,41642,41642,116506,74864,74864,1587,0,0,0
116546,application_1508364558011_37508,1,72309,72309,116546,44237,44237,1098,0,0,0
116570,application_1506638472019_0901,1,9359,9359,116570,107211,107211,5480,0,0,0
116570,application_1508364558011_9281,1,42060,42060,116570,74510,74510,1598,0,0,0
116600,application_1506638472019_21842,1,26333,26333,116600,90267,90267,2513,0,0,0
116610,application_1506638472019_30494,1,30969,30969,116610,85641,85641,2207,0,0,0
116610,application_1506638472019_31169,1,31200,31200,116610,85410,85410,1962,0,0,0
116610,application_1512440382012_5958,1,112836,112836,116610,3774,3774,62,0,0,0
116610,application_1511916184019_2812,2,103036,103036,116610,13574,13574,30,0,0,0
116630,application_1513025660013_0431,1,115585,115585,116630,1045,1045,44,0,0,0
116630,application_1511916184019_2774,2,102820,102820,116630,13810,13810,47,0,0,0
116650,application_1506638472019_5488,1,15895,15895,116650,100755,100755,3690,0,0,0
116650,application_1508364558011_49873,1,86379,86379,116650,30271,30271,610,0,0,0
116663,application_1511916184019_3245,2,104206,104206,116663,12457,12457,18,0,0,0
116683,application_1508364558011_43558,1,77894,77894,116683,38789,38789,890,0,0,0
116693,application_1512440382012_0057,1,105255,105255,116693,11438,11438,332,0,0,0
116713,application_1506638472019_30592,1,31000,31000,116713,85713,85713,2014,0,0,0
116723,application_1508364558011_8639,1,41645,41645,116723,75078,75078,1580,0,0,0
116733,application_1506638472019_30065,1,30922,30922,116733,85811,85811,1993,0,0,0
116743,application_1508364558011_18781,1,48067,48067,116743,68676,68676,1337,0,0,0
116793,application_1508364558011_19712,1,49114,49114,116793,67679,67679,1368,0,0,0
116833,application_1506638472019_22840,1,26996,26996,116833,89837,89837,2459,0,0,0
116843,application_1506638472019_23365,1,27185,27185,116843,89658,89658,2708,0,0,0
116853,application_1512440382012_6333,1,114110,114110,116853,2743,2743,132,0,0,0
116873,application_1506638472019_16902,1,23312,23312,116873,93561,93561,2919,0,0,0
116903,application_1508364558011_39653,1,73759,73759,116903,43144,43144,1127,0,0,0
116915,application_1508364558011_9754,1,42137,42137,116915,74778,74778,1703,0,0,0
116935,application_1506638472019_16700,1,23274,23274,116935,93661,93661,2777,0,0,0
116935,application_1506638472019_30985,1,31045,31045,116935,85890,85890,1977,0,0,0
116935,application_1506638472019_5000,1,15812,15812,116935,101123,101123,4067,0,0,0
116935,application_1508364558011_34749,1,69784,69784,116935,47151,47151,1595,0,0,0
116945,application_1508364558011_31967,1,68414,68414,116945,48531,48531,1574,0,0,0
116945,application_1506638472019_28580,1,29195,29195,116945,87750,87750,2304,0,0,0
116945,application_1506638472019_30547,1,30995,30995,116945,85950,85950,2116,0,0,0
116995,application_1506638472019_16889,1,23310,23310,116995,93685,93685,2803,0,0,0
117035,application_1506638472019_30979,1,31045,31045,117035,85990,85990,2082,0,0,0
117045,application_1508364558011_49752,1,86248,86248,117045,30797,30797,937,0,0,0
117085,application_1506638472019_5468,1,15895,15895,117085,101190,101190,4007,0,0,0
117095,application_1506638472019_16969,1,23323,23323,117095,93772,93772,2726,0,0,0
117135,application_1508364558011_5582,1,40037,40037,117135,77098,77098,1989,0,0,0
117165,application_1512440382012_3691,1,109743,109743,117165,7422,7422,632,0,0,0
117215,application_1508364558011_9728,1,42137,42137,117215,75078,75078,1904,0,0,0
117225,application_1512440382012_2837,1,109589,109589,117225,7636,7636,642,0,0,0
117245,application_1506638472019_24129,1,27344,27344,117245,89901,89901,2682,0,0,0
117255,application_1506638472019_5198,1,15819,15819,117255,101436,101436,3749,0,0,0
117265,application_1508364558011_16614,1,46687,46687,117265,70578,70578,2363,0,0,0
117295,application_1508364558011_17529,1,47591,47591,117295,69704,69704,1683,0,0,0
117365,application_1506638472019_25378,1,27830,27830,117365,89535,89535,2789,0,0,0
117375,application_1508364558011_20627,1,49892,49892,117375,67483,67483,2248,0,0,0
117405,application_1506638472019_18387,1,24591,24591,117405,92814,92814,2102,0,0,0
117451,application_1508364558011_9628,1,42067,42067,117451,75384,75384,2243,0,0,0
117461,application_1506638472019_26708,1,28567,28567,117461,88894,88894,3360,0,0,0
117561,application_1508364558011_31552,1,67770,67770,117561,49791,49791,1790,0,0,0
117571,application_1508364558011_34559,1,69782,69782,117571,47789,47789,1905,0,0,0
117581,application_1508364558011_8515,1,41643,41643,117581,75938,75938,1792,0,0,0
117601,application_1512440382012_5391,1,110637,110637,117601,6964,6964,1066,0,0,0
117601,application_1506638472019_6353,1,17055,17055,117601,100546,100546,4391,0,0,0
117671,application_1508364558011_4607,1,39800,39800,117671,77871,77871,2453,0,0,0
117721,application_1506638472019_16074,1,22952,22952,117721,94769,94769,3462,0,0,0
117781,application_1508364558011_16334,1,46503,46503,117781,71278,71278,1621,0,0,0
117871,application_1511916184019_0678,1,97979,97979,117871,19892,19892,1616,0,0,0
117891,application_1506638472019_34649,1,34627,34627,117891,83264,83264,3071,0,0,0
117921,application_1508364558011_3782,1,39289,39289,117921,78632,78632,1487,0,0,0
117944,application_1511916184019_3701,2,104961,104961,117944,12983,12983,35,0,0,0
117974,application_1508364558011_10078,1,42144,42144,117974,75830,75830,1511,0,0,0
117974,application_1512440382012_4630,1,110007,110007,117974,7967,7967,206,0,0,0
118004,application_1511916184019_2334,1,101317,101317,118004,16687,16687,329,0,0,0
118054,application_1508364558011_15929,4,46277,46277,118054,71777,71777,584,0,0,0
118074,application_1506638472019_27312,1,28729,28729,118074,89345,89345,3337,0,0,0
118084,application_1506638472019_28220,1,29108,29108,118084,88976,88976,2303,0,0,0
118094,application_1506638472019_28967,1,29317,29317,118094,88777,88777,2405,0,0,0
118094,application_1508364558011_43595,1,77896,77896,118094,40198,40198,878,0,0,0
118116,application_1508364558011_3198,1,39213,39213,118116,78903,78903,2052,0,0,0
118126,application_1506638472019_16478,1,23152,23152,118126,94974,94974,2930,0,0,0
118146,application_1508364558011_3588,1,39249,39249,118146,78897,78897,1858,0,0,0
118156,application_1506638472019_17077,1,23344,23344,118156,94812,94812,2860,0,0,0
118176,application_1506638472019_28893,1,29306,29306,118176,88870,88870,2282,0,0,0
118206,application_1512440382012_5593,1,111096,111096,118206,7110,7110,81,0,0,0
118216,application_1506638472019_18543,1,24607,24607,118216,93609,93609,2147,0,0,0
118216,application_1508364558011_39647,1,73759,73759,118216,44457,44457,766,0,0,0
118216,application_1511916184019_1484,1,99565,99565,118216,18651,18651,316,0,0,0
118256,application_1512440382012_2492,1,109106,109106,118256,9150,9150,111,0,0,0
118282,application_1512440382012_6026,1,113136,113136,118282,5146,5146,65,0,0,0
118303,application_1506638472019_18358,1,24582,24582,118303,93721,93721,2141,0,0,0
118323,application_1508364558011_2579,1,39025,39025,118323,79298,79298,2167,0,0,0
118323,application_1506638472019_28976,1,29319,29319,118323,89004,89004,2335,0,0,0
118353,application_1506638472019_30925,1,31038,31038,118353,87315,87315,1986,0,0,0
118353,application_1506638472019_28389,1,29152,29152,118353,89201,89201,2426,0,0,0
118373,application_1512440382012_2257,1,108749,108749,118373,9624,9624,207,0,0,0
118383,application_1508364558011_19689,1,49113,49113,118383,69270,69270,1394,0,0,0
118393,application_1508364558011_49846,1,86376,86376,118393,32017,32017,600,0,0,0
118393,application_1508364558011_4664,1,39803,39803,118393,78590,78590,1965,0,0,0
118406,application_1506638472019_16345,1,23126,23126,118406,95280,95280,2852,0,0,0
118416,application_1506638472019_11056,1,18670,18670,118416,99746,99746,2550,0,0,0
118426,application_1508364558011_8077,1,41623,41623,118426,76803,76803,1561,0,0,0
118431,application_1511916184019_2186,1,100839,100839,118431,17592,17592,295,0,0,0
118471,application_1512440382012_4680,1,110017,110017,118471,8454,8454,183,0,0,0
118471,application_1511916184019_1498,1,99568,99568,118471,18903,18903,304,0,0,0
118481,application_1506638472019_27837,1,29048,29048,118481,89433,89433,2393,0,0,0
118491,application_1508364558011_4909,1,39810,39810,118491,78681,78681,1859,0,0,0
118516,application_1512440382012_1569,1,107916,107916,118516,10600,10600,201,0,0,0
118523,application_1508364558011_12635,1,43588,43588,118523,74935,74935,1734,0,0,0
118563,application_1512440382012_4664,1,110016,110016,118563,8547,8547,112,0,0,0
118563,application_1512440382012_5772,1,112116,112116,118563,6447,6447,75,0,0,0
118583,application_1508364558011_28766,1,64777,64777,118583,53806,53806,1526,0,0,0
118593,application_1506638472019_30263,1,30944,30944,118593,87649,87649,2060,0,0,0
118603,application_1512440382012_5857,1,112476,112476,118603,6127,6127,71,0,0,0
118613,application_1513025660013_0003,1,114962,114962,118613,3651,3651,53,0,0,0
118633,application_1512440382012_4655,1,110009,110009,118633,8624,8624,170,0,0,0
118663,application_1508364558011_10094,1,42145,42145,118663,76518,76518,2036,0,0,0
118663,application_1508364558011_14147,1,44894,44894,118663,73769,73769,1585,0,0,0
118673,application_1508364558011_6458,1,40810,40810,118673,77863,77863,1774,0,0,0
118683,application_1512440382012_5999,1,112996,112996,118683,5687,5687,61,0,0,0
118693,application_1513025660013_0936,1,116536,116536,118693,2157,2157,57,0,0,0
118709,application_1508364558011_33566,1,69525,69525,118709,49184,49184,1437,0,0,0
118709,application_1506638472019_36564,1,35245,35245,118709,83464,83464,1719,0,0,0
118719,application_1512440382012_5280,1,110546,110546,118719,8173,8173,85,0,0,0
118731,application_1508364558011_39579,1,73753,73753,118731,44978,44978,752,0,0,0
118776,application_1513025660013_0018,1,114978,114978,118776,3798,3798,60,0,0,0
118812,application_1508364558011_44230,1,78122,78122,118812,40690,40690,787,0,0,0
118832,application_1508364558011_16604,1,46686,46686,118832,72146,72146,1653,0,0,0
118887,application_1506638472019_30970,1,31043,31043,118887,87844,87844,1967,0,0,0
118897,application_1506638472019_5581,1,15898,15898,118897,102999,102999,3039,0,0,0
118897,application_1512440382012_4624,1,110007,110007,118897,8890,8890,173,0,0,0
118907,application_1506638472019_31171,1,31200,31200,118907,87707,87707,1999,0,0,0
118917,application_1511916184019_1527,1,99574,99574,118917,19343,19343,311,0,0,0
118947,application_1513025660013_0553,1,115757,115757,118947,3190,3190,40,0,0,0
118957,application_1512440382012_5443,1,110756,110756,118957,8201,8201,86,0,0,0
118987,application_1508364558011_4163,1,39361,39361,118987,79626,79626,2099,0,0,0
118987,application_1506638472019_30368,1,30956,30956,118987,88031,88031,2017,0,0,0
119017,application_1512440382012_5888,1,112626,112626,119017,6391,6391,66,0,0,0
119027,application_1513627406021_0425,1,118431,118431,119027,596,596,13,0,0,0
119047,application_1506638472019_21729,1,26321,26321,119047,92726,92726,2324,0,0,0
119047,application_1508364558011_7112,1,41277,41277,119047,77770,77770,1549,0,0,0
119067,application_1513627406021_0197,1,118206,118206,119067,861,861,67,0,0,0
119087,application_1512440382012_5706,1,111726,111726,119087,7361,7361,82,0,0,0
119087,application_1512440382012_2499,4,109111,109111,119087,9976,9976,161,0,0,0
119088,application_1511916184019_2366,1,101325,101325,119088,17763,17763,346,0,0,0
119098,application_1513627406021_0022,1,117901,117901,119098,1197,1197,53,0,0,0
119108,application_1508364558011_2211,1,39001,39001,119108,80107,80107,1691,0,0,0
119108,application_1513025660013_0754,1,116246,116246,119108,2862,2862,65,0,0,0
119118,application_1512440382012_5950,1,112806,112806,119118,6312,6312,62,0,0,0
119168,application_1506638472019_28497,1,29180,29180,119168,89988,89988,2425,0,0,0
119168,application_1513025660013_0865,1,116426,116426,119168,2742,2742,67,0,0,0
119168,application_1508364558011_5837,1,40042,40042,119168,79126,79126,1788,0,0,0
119168,application_1506638472019_16399,1,23137,23137,119168,96031,96031,2687,0,0,0
119188,application_1512440382012_4670,1,110017,110017,119188,9171,9171,174,0,0,0
119188,application_1506638472019_27858,1,29051,29051,119188,90137,90137,2481,0,0,0
119228,application_1508364558011_33563,1,69524,69524,119228,49704,49704,845,0,0,0
119238,application_1506638472019_28559,1,29192,29192,119238,90046,90046,2442,0,0,0
119238,application_1512440382012_4715,1,110019,110019,119238,9219,9219,177,0,0,0
119238,application_1506638472019_9152,1,17589,17589,119238,101649,101649,2665,0,0,0
119238,application_1506638472019_22538,1,26859,26859,119238,92379,92379,3003,0,0,0
119248,application_1506638472019_30373,1,30956,30956,119248,88292,88292,2031,0,0,0
119248,application_1508364558011_32251,1,68566,68566,119248,50682,50682,1812,0,0,0
119268,application_1511916184019_3451,1,104483,104483,119268,14785,14785,306,0,0,0
119278,application_1508364558011_39831,1,73774,73774,119278,45504,45504,1113,0,0,0
119288,application_1511528684064_1101,1,94750,94750,119288,24538,24538,561,0,0,0
119298,application_1508364558011_7170,1,41278,41278,119298,78020,78020,2282,0,0,0
119308,application_1508364558011_15354,1,45569,45569,119308,73739,73739,1638,0,0,0
119308,application_1506638472019_28230,1,29111,29111,119308,90197,90197,2431,0,0,0
119324,application_1512440382012_1105,1,106882,106882,119324,12442,12442,182,0,0,0
119324,application_1513627406021_0018,1,117900,117900,119324,1424,1424,55,0,0,0
119344,application_1506638472019_30677,1,31010,31010,119344,88334,88334,2030,0,0,0
119344,application_1508364558011_49860,1,86378,86378,119344,32966,32966,601,0,0,0
119354,application_1511916184019_1440,1,99557,99557,119354,19797,19797,332,0,0,0
119394,application_1506638472019_7052,1,17156,17156,119394,102238,102238,2642,0,0,0
119404,application_1508364558011_24445,1,56912,56912,119404,62492,62492,1152,0,0,0
119404,application_1506638472019_5006,1,15812,15812,119404,103592,103592,3463,0,0,0
119424,application_1508364558011_9691,1,42136,42136,119424,77288,77288,2082,0,0,0
119424,application_1512440382012_6351,1,114121,114121,119424,5303,5303,90,0,0,0
119444,application_1508364558011_1880,1,38852,38852,119444,80592,80592,1710,0,0,0
119444,application_1513025660013_1079,1,116905,116905,119444,2539,2539,55,0,0,0
119464,application_1512440382012_4676,1,110017,110017,119464,9447,9447,185,0,0,0
119491,application_1512440382012_4759,1,110022,110022,119491,9469,9469,212,0,0,0
119491,application_1506638472019_30876,1,31033,31033,119491,88458,88458,1994,0,0,0
119521,application_1508364558011_9844,1,42138,42138,119521,77383,77383,1572,0,0,0
119551,application_1513627406021_0033,1,117934,117934,119551,1617,1617,36,0,0,0
119561,application_1508364558011_33569,1,69525,69525,119561,50036,50036,806,0,0,0
119571,application_1512440382012_1758,1,108212,108212,119571,11359,11359,205,0,0,0
119641,application_1513025660013_0657,1,116006,116006,119641,3635,3635,69,0,0,0
119660,application_1512440382012_4667,1,110016,110016,119660,9644,9644,127,0,0,0
119686,application_1506638472019_4860,1,15804,15804,119686,103882,103882,3736,0,0,0
119696,application_1508364558011_20966,1,50266,50266,119696,69430,69430,1727,0,0,0
119706,application_1506638472019_30099,1,30925,30925,119706,88781,88781,2107,0,0,0
119716,application_1506638472019_31206,1,31207,31207,119716,88509,88509,2023,0,0,0
119746,application_1506638472019_30255,1,30943,30943,119746,88803,88803,1947,0,0,0
119756,application_1508364558011_6475,1,40810,40810,119756,78946,78946,1650,0,0,0
119778,application_1508364558011_32314,1,68612,68612,119778,51166,51166,1891,0,0,0
119778,application_1508364558011_49874,1,86380,86380,119778,33398,33398,554,0,0,0
119788,application_1513025660013_0940,1,116546,116546,119788,3242,3242,69,0,0,0
119826,application_1506638472019_30632,1,31005,31005,119826,88821,88821,2019,0,0,0
119836,application_1506638472019_30998,1,31047,31047,119836,88789,88789,1966,0,0,0
119846,application_1513025660013_0585,1,115826,115826,119846,4020,4020,66,0,0,0
119856,application_1512440382012_5409,1,110693,110693,119856,9163,9163,235,0,0,0
119886,application_1513627406021_0472,1,118496,118496,119886,1390,1390,67,0,0,0
119906,application_1506638472019_9051,1,17575,17575,119906,102331,102331,2798,0,0,0
119916,application_1506638472019_13060,1,19837,19837,119916,100079,100079,2839,0,0,0
119926,application_1508364558011_6764,1,40815,40815,119926,79111,79111,1697,0,0,0
120022,application_1506638472019_5161,1,15818,15818,120022,104204,104204,4000,0,0,0
120032,application_1506638472019_18654,1,24619,24619,120032,95413,95413,2173,0,0,0
120092,application_1513627406021_0122,1,118116,118116,120092,1976,1976,69,0,0,0
120092,application_1513627406021_0156,1,118166,118166,120092,1926,1926,72,0,0,0
120102,application_1508364558011_47049,1,80159,80159,120102,39943,39943,911,0,0,0
120132,application_1512440382012_2581,1,109292,109292,120132,10840,10840,177,0,0,0
120206,application_1511916184019_2431,1,101343,101343,120206,18863,18863,323,0,0,0
120236,application_1508364558011_0460,4,37560,37560,120236,82676,82676,772,0,0,0
120246,application_1508364558011_9802,1,42138,42138,120246,78108,78108,1505,0,0,0
120246,application_1506638472019_17029,1,23335,23335,120246,96911,96911,2833,0,0,0
120276,application_1508364558011_9720,1,42136,42136,120276,78140,78140,1845,0,0,0
120276,application_1506638472019_4965,1,15810,15810,120276,104466,104466,3307,0,0,0
120286,application_1506638472019_30562,1,30997,30997,120286,89289,89289,2023,0,0,0
120286,application_1508364558011_49901,1,86383,86383,120286,33903,33903,715,0,0,0
120296,application_1508364558011_39470,1,73652,73652,120296,46644,46644,898,0,0,0
120336,application_1512440382012_4589,1,110005,110005,120336,10331,10331,175,0,0,0
120346,application_1508364558011_9738,1,42137,42137,120346,78209,78209,2065,0,0,0
120346,application_1508364558011_43714,1,77907,77907,120346,42439,42439,878,0,0,0
120346,application_1512440382012_1850,1,108319,108319,120346,12027,12027,196,0,0,0
120356,application_1508364558011_39957,1,73787,73787,120356,46569,46569,849,0,0,0
120377,application_1506638472019_27430,1,28744,28744,120377,91633,91633,3526,0,0,0
120387,application_1508364558011_9701,1,42136,42136,120387,78251,78251,1936,0,0,0
120397,application_1511916184019_1745,1,99777,99777,120397,20620,20620,325,0,0,0
120397,application_1508364558011_29049,1,65300,65300,120397,55097,55097,2357,0,0,0
120407,application_1512440382012_6724,1,114903,114903,120407,5504,5504,65,0,0,0
120417,application_1506638472019_27185,1,28715,28715,120417,91702,91702,3381,0,0,0
120417,application_1512440382012_1787,1,108215,108215,120417,12202,12202,196,0,0,0
120466,application_1508364558011_39523,1,73748,73748,120466,46718,46718,1090,0,0,0
120516,application_1508364558011_19371,1,48799,48799,120516,71717,71717,1387,0,0,0
120536,application_1512440382012_1549,1,107866,107866,120536,12670,12670,172,0,0,0
120546,application_1508364558011_8478,1,41642,41642,120546,78904,78904,1967,0,0,0
120546,application_1506638472019_3535,1,13438,13438,120546,107108,107108,4162,0,0,0
120556,application_1508364558011_18846,1,48070,48070,120556,72486,72486,1576,0,0,0
120556,application_1512440382012_1753,1,108211,108211,120556,12345,12345,250,0,0,0
120576,application_1508364558011_8265,1,41626,41626,120576,78950,78950,1579,0,0,0
120586,application_1513025660013_1020,1,116753,116753,120586,3833,3833,23,0,0,0
120586,application_1513025660013_0858,1,116406,116406,120586,4180,4180,53,0,0,0
120605,application_1506638472019_37009,1,35533,35533,120605,85072,85072,2521,0,0,0
120635,application_1508364558011_32481,1,68645,68645,120635,51990,51990,1758,0,0,0
120635,application_1508364558011_39421,1,73648,73648,120635,46987,46987,785,0,0,0
120646,application_1508364558011_21332,1,50723,50723,120646,69923,69923,1665,0,0,0
120666,application_1506638472019_16394,1,23135,23135,120666,97531,97531,2723,0,0,0
120688,application_1506638472019_21463,1,26294,26294,120688,94394,94394,2618,0,0,0
120708,application_1508364558011_47123,1,80241,80241,120708,40467,40467,874,0,0,0
120718,application_1513025660013_0457,1,115626,115626,120718,5092,5092,80,0,0,0
120728,application_1512440382012_2012,1,108472,108472,120728,12256,12256,160,0,0,0
120758,application_1506638472019_16780,1,23290,23290,120758,97468,97468,2853,0,0,0
120768,application_1506638472019_27923,1,29060,29060,120768,91708,91708,2335,0,0,0
120768,application_1511916184019_1442,1,99558,99558,120768,21210,21210,309,0,0,0
120818,application_1508364558011_17624,1,47664,47664,120818,73154,73154,1438,0,0,0
120828,application_1513025660013_0790,1,116306,116306,120828,4522,4522,68,0,0,0
120848,application_1508364558011_24415,1,56908,56908,120848,63940,63940,1209,0,0,0
120878,application_1512440382012_4756,1,110022,110022,120878,10856,10856,171,0,0,0
120878,application_1513025660013_0401,1,115557,115557,120878,5321,5321,39,0,0,0
120898,application_1506638472019_30573,1,30998,30998,120898,89900,89900,1974,0,0,0
120936,application_1511916184019_2346,1,101321,101321,120936,19615,19615,329,0,0,0
120986,application_1506638472019_25422,1,27836,27836,120986,93150,93150,2619,0,0,0
120996,application_1508364558011_21341,1,50723,50723,120996,70273,70273,1808,0,0,0
120996,application_1511916184019_1537,1,99577,99577,120996,21419,21419,307,0,0,0
121006,application_1513627406021_1527,1,120926,120926,121006,80,80,71,0,0,0
121006,application_1508364558011_8845,1,41848,41848,121006,79158,79158,1507,0,0,0
121006,application_1508364558011_27937,1,62276,62276,121006,58730,58730,1369,0,0,0
121046,application_1508364558011_33920,1,69705,69705,121046,51341,51341,1568,0,0,0
121086,application_1508364558011_15103,1,45565,45565,121086,75521,75521,2378,0,0,0
121096,application_1506638472019_31020,1,31075,31075,121096,90021,90021,1953,0,0,0
121096,application_1513025660013_0609,1,115916,115916,121096,5180,5180,68,0,0,0
121117,application_1506638472019_28587,1,29196,29196,121117,91921,91921,2483,0,0,0
121146,application_1506638472019_30372,1,30956,30956,121146,90190,90190,2021,0,0,0
121146,application_1508364558011_36466,4,70755,70755,121146,50391,50391,823,0,0,0
121164,application_1512440382012_6493,1,114316,114316,121164,6848,6848,75,0,0,0
121194,application_1512440382012_5424,1,110694,110694,121194,10500,10500,204,0,0,0
121226,application_1506638472019_30249,1,30943,30943,121226,90283,90283,1992,0,0,0
121236,application_1506638472019_5553,1,15897,15897,121236,105339,105339,4053,0,0,0
121236,application_1508364558011_37525,1,72310,72310,121236,48926,48926,887,0,0,0
121236,application_1506638472019_16152,1,23086,23086,121236,98150,98150,2741,0,0,0
121256,application_1511916184019_3082,1,103980,103980,121256,17276,17276,691,0,0,0
121256,application_1511916184019_3152,1,104123,104123,121256,17133,17133,264,0,0,0
121276,application_1508364558011_16094,1,46389,46389,121276,74887,74887,1621,0,0,0
121332,application_1513627406021_1778,1,121322,121322,121332,10,10,3,0,0,0
121361,application_1513627406021_0592,1,118756,118756,121361,2605,2605,70,0,0,0
121381,application_1506638472019_16683,1,23270,23270,121381,98111,98111,2730,0,0,0
121381,application_1513627406021_1199,1,120136,120136,121381,1245,1245,76,0,0,0
121411,application_1511916184019_1714,1,99768,99768,121411,21643,21643,327,0,0,0
121421,application_1506638472019_30169,1,30934,30934,121421,90487,90487,1923,0,0,0
121497,application_1508364558011_34390,1,69774,69774,121497,51723,51723,860,0,0,0
121507,application_1506638472019_25611,1,27857,27857,121507,93650,93650,2668,0,0,0
121546,application_1513627406021_1814,1,121339,121339,121546,207,207,6,0,0,0
121546,application_1508364558011_33998,1,69720,69720,121546,51826,51826,885,0,0,0
121546,application_1508364558011_36720,4,71193,71193,121546,50353,50353,706,0,0,0
121566,application_1508364558011_43887,1,77924,77924,121566,43642,43642,884,0,0,0
121586,application_1508364558011_2423,1,39012,39012,121586,82574,82574,1809,0,0,0
121586,application_1506638472019_23052,1,27087,27087,121586,94499,94499,2417,0,0,0
121685,application_1508364558011_20835,1,50171,50171,121685,71514,71514,1444,0,0,0
121695,application_1508364558011_3170,1,39209,39209,121695,82486,82486,1739,0,0,0
121695,application_1508364558011_5640,1,40038,40038,121695,81657,81657,1864,0,0,0
121725,application_1506638472019_28266,1,29133,29133,121725,92592,92592,2429,0,0,0
121805,application_1508364558011_4969,1,39859,39859,121805,81946,81946,2066,0,0,0
121815,application_1508364558011_17664,1,47666,47666,121815,74149,74149,1406,0,0,0
121845,application_1513627406021_1254,1,120336,120336,121845,1509,1509,67,0,0,0
121855,application_1513627406021_1305,1,120496,120496,121855,1359,1359,78,0,0,0
121855,application_1508364558011_49906,1,86384,86384,121855,35471,35471,615,0,0,0
121865,application_1513627406021_1458,1,120828,120828,121865,1037,1037,59,0,0,0
121865,application_1506638472019_17066,1,23342,23342,121865,98523,98523,2811,0,0,0
121895,application_1513025660013_0340,1,115444,115444,121895,6451,6451,85,0,0,0
121969,application_1508364558011_5619,1,40037,40037,121969,81932,81932,1722,0,0,0
121969,application_1513627406021_1031,1,119826,119826,121969,2143,2143,71,0,0,0
121979,application_1506638472019_9189,1,17594,17594,121979,104385,104385,3798,0,0,0
122009,application_1508364558011_40375,1,73900,73900,122009,48109,48109,910,0,0,0
122029,application_1512440382012_2248,1,108747,108747,122029,13282,13282,177,0,0,0
122029,application_1512440382012_6175,1,113856,113856,122029,8173,8173,222,0,0,0
122039,application_1508364558011_3182,1,39211,39211,122039,82828,82828,2436,0,0,0
122047,application_1511916184019_2384,1,101327,101327,122047,20720,20720,344,0,0,0
122063,application_1513025660013_0751,1,116236,116236,122063,5827,5827,60,0,0,0
122073,application_1506638472019_5592,1,15899,15899,122073,106174,106174,3919,0,0,0
122083,application_1506638472019_28432,1,29158,29158,122083,92925,92925,2387,0,0,0
122196,application_1506638472019_28376,1,29151,29151,122196,93045,93045,2338,0,0,0
122212,application_1506638472019_5455,1,15894,15894,122212,106318,106318,4076,0,0,0
122236,application_1513025660013_0479,1,115653,115653,122236,6583,6583,81,0,0,0
122256,application_1512440382012_1287,1,107208,107208,122256,15048,15048,332,0,0,0
122256,application_1508364558011_4098,1,39359,39359,122256,82897,82897,1672,0,0,0
122256,application_1506638472019_27825,1,29045,29045,122256,93211,93211,2473,0,0,0
122276,application_1508364558011_39479,1,73654,73654,122276,48622,48622,917,0,0,0
122296,application_1506638472019_30971,1,31043,31043,122296,91253,91253,1956,0,0,0
122311,application_1506638472019_23712,1,27262,27262,122311,95049,95049,2718,0,0,0
122336,application_1506638472019_30146,1,30931,30931,122336,91405,91405,2030,0,0,0
122356,application_1508364558011_6518,1,40811,40811,122356,81545,81545,1835,0,0,0
122363,application_1508364558011_37503,1,72309,72309,122363,50054,50054,901,0,0,0
122381,application_1506638472019_22284,1,26536,26536,122381,95845,95845,2448,0,0,0
122401,application_1513627406021_0973,1,119686,119686,122401,2715,2715,64,0,0,0
122446,application_1506638472019_17004,1,23329,23329,122446,99117,99117,2723,0,0,0
122456,application_1506638472019_22150,1,26521,26521,122456,95935,95935,2515,0,0,0
122466,application_1506638472019_30340,1,30953,30953,122466,91513,91513,2022,0,0,0
122481,application_1511916184019_2411,1,101338,101338,122481,21143,21143,319,0,0,0
122481,application_1508364558011_24631,1,57289,57289,122481,65192,65192,1424,0,0,0
122521,application_1506638472019_5414,1,15893,15893,122521,106628,106628,3231,0,0,0
122526,application_1508364558011_16637,1,46688,46688,122526,75838,75838,1698,0,0,0
122546,application_1513025660013_0325,1,115431,115431,122546,7115,7115,202,0,0,0
122546,application_1506638472019_22522,1,26804,26804,122546,95742,95742,2574,0,0,0
122556,application_1508364558011_43738,1,77910,77910,122556,44646,44646,943,0,0,0
122646,application_1513627406021_1367,1,120636,120636,122646,2010,2010,66,0,0,0
122656,application_1508364558011_49924,1,86386,86386,122656,36270,36270,649,0,0,0
122666,application_1508364558011_29239,4,65459,65459,122666,57207,57207,785,0,0,0
122696,application_1511916184019_2404,1,101336,101336,122696,21360,21360,336,0,0,0
122696,application_1508364558011_33818,1,69691,69691,122696,53005,53005,848,0,0,0
122700,application_1508364558011_0845,4,37943,37943,122700,84757,84757,4452,0,0,0
122720,application_1506638472019_22104,1,26516,26516,122720,96204,96204,2581,0,0,0
122730,application_1508364558011_33948,1,69712,69712,122730,53018,53018,1647,0,0,0
122760,application_1506638472019_21922,1,26343,26343,122760,96417,96417,2398,0,0,0
122790,application_1508364558011_4122,1,39360,39360,122790,83430,83430,1769,0,0,0
122800,application_1506638472019_8157,1,17294,17294,122800,105506,105506,2856,0,0,0
122800,application_1508364558011_19669,1,49112,49112,122800,73688,73688,1510,0,0,0
122800,application_1512440382012_2606,1,109313,109313,122800,13487,13487,335,0,0,0
122810,application_1508364558011_49847,1,86376,86376,122810,36434,36434,703,0,0,0
122850,application_1512440382012_4592,1,110005,110005,122850,12845,12845,167,0,0,0
122850,application_1506638472019_30228,1,30940,30940,122850,91910,91910,2079,0,0,0
122850,application_1512440382012_0518,2,106001,106001,122850,16849,16849,30,0,0,0
122880,application_1508364558011_5783,1,40041,40041,122880,82839,82839,1847,0,0,0
122880,application_1508364558011_7042,1,41189,41189,122880,81691,81691,1775,0,0,0
122900,application_1513025660013_0888,1,116456,116456,122900,6444,6444,63,0,0,0
122910,application_1512440382012_0627,2,106177,106177,122910,16733,16733,21,0,0,0
122920,application_1508364558011_42771,1,76702,76702,122920,46218,46218,1611,0,0,0
122920,application_1506638472019_30441,1,30963,30963,122920,91957,91957,1977,0,0,0
122930,application_1513627406021_1699,1,121206,121206,122930,1724,1724,66,0,0,0
122990,application_1508364558011_5071,1,39861,39861,122990,83129,83129,1918,0,0,0
123000,application_1508364558011_21420,1,50726,50726,123000,72274,72274,1329,0,0,0
123020,application_1508364558011_24409,1,56907,56907,123020,66113,66113,1380,0,0,0
123030,application_1508364558011_17429,1,47484,47484,123030,75546,75546,1705,0,0,0
123030,application_1508364558011_17488,1,47490,47490,123030,75540,75540,1652,0,0,0
123030,application_1512440382012_1064,2,106798,106798,123030,16232,16232,23,0,0,0
123040,application_1512440382012_0956,2,106641,106641,123040,16399,16399,31,0,0,0
123050,application_1508364558011_5583,1,40037,40037,123050,83013,83013,1669,0,0,0
123070,application_1513627406021_2141,1,122126,122126,123070,944,944,59,0,0,0
123080,application_1513627406021_2476,1,122436,122436,123080,644,644,64,0,0,0
123090,application_1511916184019_2354,1,101322,101322,123090,21768,21768,318,0,0,0
123090,application_1512440382012_4965,2,110191,110191,123090,12899,12899,21,0,0,0
123100,application_1508364558011_20818,1,50147,50147,123100,72953,72953,1331,0,0,0
123100,application_1506638472019_30366,1,30956,30956,123100,92144,92144,2141,0,0,0
123130,application_1513627406021_1971,1,121566,121566,123130,1564,1564,73,0,0,0
123130,application_1506638472019_18461,1,24598,24598,123130,98532,98532,2201,0,0,0
123140,application_1513627406021_0485,1,118516,118516,123140,4624,4624,65,0,0,0
123150,application_1512440382012_5611,2,111226,111226,123150,11924,11924,28,0,0,0
123180,application_1508364558011_49864,1,86378,86378,123180,36802,36802,590,0,0,0
123200,application_1513627406021_1333,1,120566,120566,123200,2634,2634,80,0,0,0
123210,application_1512440382012_1725,1,108206,108206,123210,15004,15004,253,0,0,0
123210,application_1512440382012_5749,2,111965,111965,123210,11245,11245,25,0,0,0
123210,application_1512440382012_5750,2,111965,111965,123210,11245,11245,25,0,0,0
123220,application_1508364558011_4851,1,39809,39809,123220,83411,83411,2506,0,0,0
123240,application_1508364558011_45473,1,78338,78338,123240,44902,44902,647,0,0,0
123240,application_1513627406021_1116,1,119952,119952,123240,3288,3288,79,0,0,0
123240,application_1512440382012_6064,2,113446,113446,123240,9794,9794,27,0,0,0
123270,application_1511916184019_1722,1,99769,99769,123270,23501,23501,338,0,0,0
123270,application_1508364558011_6734,1,40814,40814,123270,82456,82456,1623,0,0,0
123320,application_1513627406021_2317,1,122301,122301,123320,1019,1019,63,0,0,0
123320,application_1508364558011_9106,1,41852,41852,123320,81468,81468,1634,0,0,0
123330,application_1506638472019_30430,1,30962,30962,123330,92368,92368,2088,0,0,0
123330,application_1512440382012_6425,2,114184,114184,123330,9146,9146,26,0,0,0
123340,application_1508364558011_32440,1,68641,68641,123340,54699,54699,1624,0,0,0
123350,application_1508364558011_5904,1,40043,40043,123350,83307,83307,1689,0,0,0
123350,application_1508364558011_7055,1,41190,41190,123350,82160,82160,1774,0,0,0
123390,application_1513025660013_0144,2,115175,115175,123390,8215,8215,25,0,0,0
123400,application_1508364558011_24799,1,57372,57372,123400,66028,66028,1225,0,0,0
123400,application_1513627406021_0987,1,119716,119716,123400,3684,3684,83,0,0,0
123430,application_1513025660013_0898,1,116486,116486,123430,6944,6944,63,0,0,0
123450,application_1513025660013_0272,2,115333,115333,123450,8117,8117,26,0,0,0
123480,application_1513025660013_0486,2,115665,115665,123480,7815,7815,21,0,0,0
123530,application_1513025660013_0533,2,115719,115719,123530,7811,7811,41,0,0,0
123540,application_1508364558011_20696,1,50005,50005,123540,73535,73535,2316,0,0,0
123540,application_1513627406021_0783,1,119314,119314,123540,4226,4226,59,0,0,0
123550,application_1513627406021_0185,16,118201,118201,123550,5349,5349,4,0,0,0
123550,application_1506638472019_30949,1,31041,31041,123550,92509,92509,2137,0,0,0
123550,application_1512440382012_5412,1,110693,110693,123550,12857,12857,240,0,0,0
123570,application_1511916184019_2391,1,101332,101332,123570,22238,22238,341,0,0,0
123570,application_1508364558011_40398,1,73902,73902,123570,49668,49668,932,0,0,0
123580,application_1513025660013_0942,2,116560,116560,123580,7020,7020,31,0,0,0
123590,application_1506638472019_16767,1,23287,23287,123590,100303,100303,2896,0,0,0
123610,application_1506638472019_23012,1,27061,27061,123610,96549,96549,2144,0,0,0
123620,application_1508364558011_19013,1,48251,48251,123620,75369,75369,1604,0,0,0
123630,application_1511916184019_1624,1,99718,99718,123630,23912,23912,477,0,0,0
123630,application_1508364558011_5090,1,39861,39861,123630,83769,83769,2885,0,0,0
123640,application_1513627406021_2306,1,122276,122276,123640,1364,1364,66,0,0,0
123710,application_1508364558011_20803,1,50146,50146,123710,73564,73564,1506,0,0,0
123710,application_1512440382012_1995,1,108445,108445,123710,15265,15265,175,0,0,0
123730,application_1513025660013_0781,1,116276,116276,123730,7454,7454,68,0,0,0
123740,application_1508364558011_19392,1,48801,48801,123740,74939,74939,1505,0,0,0
123740,application_1513627406021_1633,1,121136,121136,123740,2604,2604,65,0,0,0
123740,application_1513025660013_0326,1,115431,115431,123740,8309,8309,131,0,0,0
123760,application_1513627406021_0527,2,118583,118583,123760,5177,5177,32,0,0,0
123780,application_1512440382012_4567,1,110003,110003,123780,13777,13777,260,0,0,0
123810,application_1506638472019_7727,1,17251,17251,123810,106559,106559,3831,0,0,0
123810,application_1506638472019_28413,1,29155,29155,123810,94655,94655,2392,0,0,0
123810,application_1513627406021_2094,2,121979,121979,123810,1831,1831,23,0,0,0
123810,application_1513627406021_2531,2,122570,122570,123810,1240,1240,28,0,0,0
123850,application_1512440382012_1705,1,108204,108204,123850,15646,15646,330,0,0,0
123900,application_1506638472019_22884,1,27001,27001,123900,96899,96899,2452,0,0,0
123910,application_1506638472019_21324,1,26277,26277,123910,97633,97633,2491,0,0,0
123930,application_1508364558011_14096,1,44888,44888,123930,79042,79042,1689,0,0,0
123940,application_1508364558011_16651,1,46688,46688,123940,77252,77252,1633,0,0,0
123940,application_1506638472019_30988,1,31046,31046,123940,92894,92894,2105,0,0,0
123940,application_1508364558011_4929,1,39810,39810,123940,84130,84130,1923,0,0,0
123960,application_1513627406021_1956,1,121526,121526,123960,2434,2434,63,0,0,0
123980,application_1512440382012_0589,2,106146,106146,123980,17834,17834,45,0,0,0
124010,application_1513627406021_0963,1,119666,119666,124010,4344,4344,66,0,0,0
124010,application_1506638472019_30502,1,30970,30970,124010,93040,93040,2053,0,0,0
124070,application_1508364558011_5632,1,40038,40038,124070,84032,84032,1717,0,0,0
124090,application_1506638472019_30089,1,30924,30924,124090,93166,93166,1996,0,0,0
124110,application_1508364558011_10435,1,42150,42150,124110,81960,81960,2242,0,0,0
124110,application_1506638472019_30858,1,31032,31032,124110,93078,93078,1998,0,0,0
124120,application_1508364558011_9797,1,42138,42138,124120,81982,81982,2103,0,0,0
124120,application_1508364558011_24798,1,57372,57372,124120,66748,66748,1272,0,0,0
124170,application_1508364558011_19366,1,48799,48799,124170,75371,75371,1885,0,0,0
124200,application_1508364558011_8071,1,41623,41623,124200,82577,82577,1686,0,0,0
124260,application_1506638472019_30438,1,30963,30963,124260,93297,93297,1936,0,0,0
124260,application_1513627406021_1975,1,121586,121586,124260,2674,2674,81,0,0,0
124260,application_1508364558011_40342,1,73898,73898,124260,50362,50362,1308,0,0,0
124280,application_1508364558011_7401,1,41282,41282,124280,82998,82998,2033,0,0,0
124280,application_1512440382012_1748,1,108211,108211,124280,16069,16069,207,0,0,0
124300,application_1513627406021_2135,1,122106,122106,124300,2194,2194,63,0,0,0
124310,application_1506638472019_30104,1,30926,30926,124310,93384,93384,2057,0,0,0
124340,application_1508364558011_39639,1,73758,73758,124340,50582,50582,874,0,0,0
124410,application_1513025660013_0834,1,116344,116344,124410,8066,8066,197,0,0,0
124440,application_1508364558011_34991,1,69882,69882,124440,54558,54558,1992,0,0,0
124450,application_1506638472019_8033,1,17283,17283,124450,107167,107167,3824,0,0,0
124460,application_1508364558011_39962,1,73787,73787,124460,50673,50673,886,0,0,0
124470,application_1508364558011_20993,1,50266,50266,124470,74204,74204,1571,0,0,0
124480,application_1508364558011_16664,1,46689,46689,124480,77791,77791,1635,0,0,0
124500,application_1508364558011_27708,1,61456,61456,124500,63044,63044,1251,0,0,0
124520,application_1513627406021_2274,1,122226,122226,124520,2294,2294,65,0,0,0
124530,application_1506638472019_37023,1,35534,35534,124530,88996,88996,1958,0,0,0
124550,application_1508364558011_32402,1,68628,68628,124550,55922,55922,1409,0,0,0
124560,application_1508364558011_20108,1,49261,49261,124560,75299,75299,1435,0,0,0
124580,application_1508364558011_29636,1,66120,66120,124580,58460,58460,1234,0,0,0
124600,application_1506638472019_28721,1,29216,29216,124600,95384,95384,2324,0,0,0
124630,application_1508364558011_6765,1,40815,40815,124630,83815,83815,1865,0,0,0
124650,application_1506638472019_21457,1,26293,26293,124650,98357,98357,2380,0,0,0
124660,application_1508364558011_21000,1,50267,50267,124660,74393,74393,1854,0,0,0
124660,application_1512440382012_4654,1,110009,110009,124660,14651,14651,210,0,0,0
124660,application_1512440382012_1745,1,108211,108211,124660,16449,16449,241,0,0,0
124670,application_1508364558011_37491,1,72308,72308,124670,52362,52362,1384,0,0,0
124710,application_1508364558011_33959,1,69712,69712,124710,54998,54998,1480,0,0,0
124720,application_1508364558011_42962,1,76920,76920,124720,47800,47800,1520,0,0,0
124720,application_1508364558011_15107,1,45565,45565,124720,79155,79155,1749,0,0,0
124720,application_1506638472019_28632,1,29202,29202,124720,95518,95518,2402,0,0,0
124720,application_1506638472019_25527,1,27848,27848,124720,96872,96872,2687,0,0,0
124730,application_1508364558011_3579,1,39249,39249,124730,85481,85481,1791,0,0,0
124750,application_1513627406021_2143,1,122136,122136,124750,2614,2614,71,0,0,0
124760,application_1508364558011_33971,1,69712,69712,124760,55048,55048,1809,0,0,0
124770,application_1513627406021_2284,1,122246,122246,124770,2524,2524,58,0,0,0
124780,application_1506638472019_30072,1,30922,30922,124780,93858,93858,2007,0,0,0
124810,application_1513627406021_2016,2,121685,121685,124810,3125,3125,26,0,0,0
124830,application_1506638472019_30918,1,31038,31038,124830,93792,93792,2017,0,0,0
124830,application_1513025660013_0698,1,116136,116136,124830,8694,8694,63,0,0,0
124850,application_1513627406021_2125,1,122047,122047,124850,2803,2803,53,0,0,0
124870,application_1508364558011_7122,1,41277,41277,124870,83593,83593,2253,0,0,0
124880,application_1508364558011_9394,1,42064,42064,124880,82816,82816,2026,0,0,0
124880,application_1506638472019_30446,1,30964,30964,124880,93916,93916,2101,0,0,0
124940,application_1512440382012_0144,2,105347,105347,124940,19593,19593,137,0,0,0
124960,application_1512440382012_6511,16,114361,114361,124960,10599,10599,160,0,0,0
125000,application_1506638472019_5387,1,15892,15892,125000,109108,109108,3528,0,0,0
125070,application_1506638472019_18183,1,24541,24541,125070,100529,100529,2159,0,0,0
125070,application_1508364558011_19674,1,49112,49112,125070,75958,75958,1438,0,0,0
125100,application_1513627406021_1984,1,121616,121616,125100,3484,3484,73,0,0,0
125110,application_1508364558011_27072,1,59915,59915,125110,65195,65195,2971,0,0,0
125170,application_1508364558011_1891,1,38852,38852,125170,86318,86318,1780,0,0,0
125200,application_1508364558011_35121,1,69883,69883,125200,55317,55317,1277,0,0,0
125210,application_1508364558011_34774,1,69785,69785,125210,55425,55425,1292,0,0,0
125240,application_1508364558011_33922,1,69705,69705,125240,55535,55535,1336,0,0,0
125270,application_1508364558011_3308,1,39219,39219,125270,86051,86051,2039,0,0,0
125300,application_1512440382012_4292,1,109911,109911,125300,15389,15389,234,0,0,0
125330,application_1508364558011_1722,1,38785,38785,125330,86545,86545,1865,0,0,0
125420,application_1512440382012_6494,1,114322,114322,125420,11098,11098,203,0,0,0
125430,application_1513627406021_2547,1,122626,122626,125430,2804,2804,78,0,0,0
125450,application_1508364558011_3760,1,39267,39267,125450,86183,86183,1990,0,0,0
125480,application_1508364558011_11441,1,43293,43293,125480,82187,82187,1782,0,0,0
125480,application_1508364558011_9171,1,41854,41854,125480,83626,83626,1660,0,0,0
125480,application_1512440382012_3223,1,109652,109652,125480,15828,15828,566,0,0,0
125500,application_1508364558011_3399,1,39228,39228,125500,86272,86272,1746,0,0,0
125520,application_1506638472019_5433,1,15894,15894,125520,109626,109626,3468,0,0,0
125520,application_1506638472019_17013,1,23331,23331,125520,102189,102189,2834,0,0,0
125520,application_1506638472019_28569,1,29193,29193,125520,96327,96327,2389,0,0,0
125580,application_1511916184019_1703,1,99765,99765,125580,25815,25815,443,0,0,0
125580,application_1508364558011_24588,1,57285,57285,125580,68295,68295,1267,0,0,0
125600,application_1512440382012_6702,1,114879,114879,125600,10721,10721,295,0,0,0
125720,application_1506638472019_31182,1,31201,31201,125720,94519,94519,2128,0,0,0
125720,application_1511916184019_1538,1,99577,99577,125720,26143,26143,439,0,0,0
125730,application_1508364558011_35092,1,69883,69883,125730,55847,55847,1924,0,0,0
125830,application_1506638472019_30542,1,30995,30995,125830,94835,94835,2073,0,0,0
125850,application_1512440382012_2457,1,109060,109060,125850,16790,16790,417,0,0,0
125860,application_1508364558011_5317,1,39869,39869,125860,85991,85991,1810,0,0,0
125870,application_1508364558011_20740,1,50008,50008,125870,75862,75862,1490,0,0,0
125880,application_1506638472019_28187,1,29102,29102,125880,96778,96778,2372,0,0,0
125930,application_1508364558011_33675,1,69539,69539,125930,56391,56391,834,0,0,0
125980,application_1506638472019_16423,1,23141,23141,125980,102839,102839,2711,0,0,0
126060,application_1508364558011_4685,1,39804,39804,126060,86256,86256,2529,0,0,0
126070,application_1508364558011_20079,1,49259,49259,126070,76811,76811,1459,0,0,0
126080,application_1508364558011_7715,1,41511,41511,126080,84569,84569,1648,0,0,0
126160,application_1513627406021_2325,1,122316,122316,126160,3844,3844,67,0,0,0
126180,application_1508364558011_4672,1,39803,39803,126180,86377,86377,1951,0,0,0
126200,application_1513627406021_2522,1,122526,122526,126200,3674,3674,67,0,0,0
126210,application_1506638472019_28238,1,29114,29114,126210,97096,97096,2367,0,0,0
126210,application_1506638472019_30941,1,31040,31040,126210,95170,95170,2015,0,0,0
126220,application_1508364558011_20105,1,49261,49261,126220,76959,76959,1475,0,0,0
126240,application_1513627406021_1728,1,121266,121266,126240,4974,4974,76,0,0,0
126240,application_1506638472019_22112,1,26516,26516,126240,99724,99724,2571,0,0,0
126250,application_1506638472019_30931,1,31039,31039,126250,95211,95211,2117,0,0,0
126260,application_1506638472019_5016,1,15812,15812,126260,110448,110448,4053,0,0,0
126270,application_1506638472019_23176,1,27165,27165,126270,99105,99105,2588,0,0,0
126330,application_1506638472019_30605,1,31002,31002,126330,95328,95328,1941,0,0,0
126400,application_1506638472019_7375,1,17210,17210,126400,109190,109190,4441,0,0,0
126410,application_1506638472019_21730,1,26321,26321,126410,100089,100089,2405,0,0,0
126430,application_1506638472019_16553,1,23166,23166,126430,103264,103264,2782,0,0,0
126460,application_1508364558011_34489,1,69779,69779,126460,56681,56681,1709,0,0,0
126520,application_1506638472019_24541,1,27700,27700,126520,98820,98820,2758,0,0,0
126520,application_1508364558011_36819,8,71372,71372,126520,55148,55148,415,0,0,0
126560,application_1508364558011_37215,1,72285,72285,126560,54275,54275,891,0,0,0
126560,application_1508364558011_2453,1,39013,39013,126560,87547,87547,1941,0,0,0
126590,application_1506638472019_27891,1,29056,29056,126590,97534,97534,2362,0,0,0
126630,application_1508364558011_16666,1,46689,46689,126630,79941,79941,1629,0,0,0
126660,application_1513627406021_1293,1,120466,120466,126660,6194,6194,82,0,0,0
126660,application_1508364558011_43806,1,77917,77917,126660,48743,48743,960,0,0,0
126680,application_1508364558011_39654,1,73759,73759,126680,52921,52921,1107,0,0,0
126760,application_1513025660013_0828,1,116343,116343,126760,10417,10417,226,0,0,0
126790,application_1513627406021_2001,1,121648,121648,126790,5142,5142,110,0,0,0
126830,application_1506638472019_30622,1,31004,31004,126830,95826,95826,1935,0,0,0
126830,application_1508364558011_15055,1,45565,45565,126830,81265,81265,1575,0,0,0
126850,application_1506638472019_22439,1,26567,26567,126850,100283,100283,2605,0,0,0
126890,application_1512440382012_2823,1,109587,109587,126890,17303,17303,629,0,0,0
126920,application_1506638472019_28784,1,29226,29226,126920,97694,97694,2448,0,0,0
126960,application_1508364558011_14379,1,45006,45006,126960,81954,81954,2054,0,0,0
127000,application_1508364558011_39648,1,73759,73759,127000,53241,53241,1137,0,0,0
127010,application_1508364558011_5819,1,40041,40041,127010,86969,86969,2362,0,0,0
127020,application_1506638472019_17043,1,23337,23337,127020,103683,103683,2766,0,0,0
127030,application_1506638472019_16586,1,23173,23173,127030,103857,103857,2692,0,0,0
127040,application_1508364558011_44209,1,78111,78111,127040,48929,48929,855,0,0,0
127050,application_1506638472019_5696,1,15902,15902,127050,111148,111148,3674,0,0,0
127050,application_1513627406021_2534,1,122576,122576,127050,4474,4474,73,0,0,0
127150,application_1506638472019_30191,1,30936,30936,127150,96214,96214,1958,0,0,0
127150,application_1506638472019_23617,1,27249,27249,127150,99901,99901,2765,0,0,0
127210,application_1506638472019_30220,1,30939,30939,127210,96271,96271,2018,0,0,0
127240,application_1508364558011_4356,1,39365,39365,127240,87875,87875,1734,0,0,0
127250,application_1506638472019_21695,1,26317,26317,127250,100933,100933,2586,0,0,0
127300,application_1508364558011_21126,1,50535,50535,127300,76765,76765,1788,0,0,0
127300,application_1508364558011_36589,1,70912,70912,127300,56388,56388,1351,0,0,0
127310,application_1506638472019_27928,1,29061,29061,127310,98249,98249,2259,0,0,0
127330,application_1506638472019_28568,1,29193,29193,127330,98137,98137,2408,0,0,0
127350,application_1506638472019_16174,1,23090,23090,127350,104260,104260,2744,0,0,0
127360,application_1508364558011_4844,1,39808,39808,127360,87552,87552,1777,0,0,0
127380,application_1508364558011_4617,1,39800,39800,127380,87580,87580,2176,0,0,0
127390,application_1508364558011_5015,1,39860,39860,127390,87530,87530,1966,0,0,0
127440,application_1506638472019_16447,1,23146,23146,127440,104294,104294,2850,0,0,0
127440,application_1506638472019_16395,1,23136,23136,127440,104304,104304,2769,0,0,0
127490,application_1506638472019_16262,1,23108,23108,127490,104382,104382,2831,0,0,0
127500,application_1506638472019_21362,1,26282,26282,127500,101218,101218,2395,0,0,0
127510,application_1506638472019_34654,1,34627,34627,127510,92883,92883,2160,0,0,0
127520,application_1506638472019_29032,1,29353,29353,127520,98167,98167,2278,0,0,0
127530,application_1506638472019_17038,1,23336,23336,127530,104194,104194,2747,0,0,0
127540,application_1506638472019_27862,1,29052,29052,127540,98488,98488,2291,0,0,0
127560,application_1508364558011_9616,1,42067,42067,127560,85493,85493,1621,0,0,0
127570,application_1506638472019_17825,1,24493,24493,127570,103077,103077,2109,0,0,0
127570,application_1506638472019_28696,1,29211,29211,127570,98359,98359,2362,0,0,0
127580,application_1508364558011_7044,1,41189,41189,127580,86391,86391,1678,0,0,0
127590,application_1508364558011_18796,1,48067,48067,127590,79523,79523,1416,0,0,0
127640,application_1513627406021_1406,1,120668,120668,127640,6972,6972,200,0,0,0
127650,application_1508364558011_15310,1,45568,45568,127650,82082,82082,1757,0,0,0
127680,application_1508364558011_34778,1,69785,69785,127680,57895,57895,1936,0,0,0
127720,application_1508364558011_36628,8,70988,70988,127720,56732,56732,470,0,0,0
127750,application_1513627406021_1355,1,120605,120605,127750,7145,7145,235,0,0,0
127790,application_1508364558011_20035,1,49258,49258,127790,78532,78532,1910,0,0,0
127820,application_1508364558011_46297,1,79219,79219,127820,48601,48601,810,0,0,0
127850,application_1506638472019_16961,1,23322,23322,127850,104528,104528,2648,0,0,0
127870,application_1506638472019_24303,1,27394,27394,127870,100476,100476,2588,0,0,0
127900,application_1513627406021_1251,1,120316,120316,127900,7584,7584,71,0,0,0
127930,application_1511916184019_1445,1,99559,99559,127930,28371,28371,446,0,0,0
127950,application_1508364558011_52890,1,89436,89436,127950,38514,38514,822,0,0,0
128010,application_1506638472019_17093,1,23347,23347,128010,104663,104663,2920,0,0,0
128080,application_1512440382012_6689,1,114847,114847,128080,13233,13233,251,0,0,0
128080,application_1508364558011_8884,1,41849,41849,128080,86231,86231,1946,0,0,0
128100,application_1508364558011_40329,1,73896,73896,128100,54204,54204,1067,0,0,0
128110,application_1508364558011_8854,1,41848,41848,128110,86262,86262,2600,0,0,0
128110,application_1508364558011_40402,1,73902,73902,128110,54208,54208,919,0,0,0
128120,application_1506638472019_28610,1,29199,29199,128120,98921,98921,2367,0,0,0
128160,application_1508364558011_3160,1,39208,39208,128160,88952,88952,2243,0,0,0
128170,application_1506638472019_22176,1,26525,26525,128170,101645,101645,2522,0,0,0
128200,application_1508364558011_20401,1,49638,49638,128200,78562,78562,2158,0,0,0
128320,application_1508364558011_35019,1,69882,69882,128320,58438,58438,1692,0,0,0
128380,application_1506638472019_16483,1,23153,23153,128380,105227,105227,2844,0,0,0
128390,application_1508364558011_6723,1,40814,40814,128390,87576,87576,1927,0,0,0
128460,application_1506638472019_30782,1,31024,31024,128460,97436,97436,1967,0,0,0
128460,application_1508364558011_16333,1,46503,46503,128460,81957,81957,1661,0,0,0
128510,application_1508364558011_5299,1,39868,39868,128510,88642,88642,1842,0,0,0
128570,application_1506638472019_24519,1,27696,27696,128570,100874,100874,2616,0,0,0
128570,application_1508364558011_27118,1,59999,59999,128570,68571,68571,1445,0,0,0
128600,application_1508364558011_7033,1,41188,41188,128600,87412,87412,1854,0,0,0
128700,application_1508364558011_8012,1,41622,41622,128700,87078,87078,1785,0,0,0
128740,application_1508364558011_6524,1,40811,40811,128740,87929,87929,1770,0,0,0
128740,application_1506638472019_5030,1,15813,15813,128740,112927,112927,3387,0,0,0
128750,application_1511916184019_3373,1,104406,104406,128750,24344,24344,398,0,0,0
128760,application_1508364558011_8490,1,41642,41642,128760,87118,87118,1705,0,0,0
128770,application_1506638472019_28020,1,29075,29075,128770,99695,99695,2299,0,0,0
128770,application_1508364558011_20962,1,50265,50265,128770,78505,78505,1883,0,0,0
128800,application_1508364558011_8003,1,41622,41622,128800,87178,87178,2036,0,0,0
128860,application_1508364558011_8888,1,41849,41849,128860,87011,87011,1677,0,0,0
128860,application_1506638472019_5086,1,15815,15815,128860,113045,113045,4080,0,0,0
128870,application_1508364558011_48806,1,84856,84856,128870,44014,44014,841,0,0,0
128880,application_1508364558011_52061,1,88072,88072,128880,40808,40808,870,0,0,0
128890,application_1508364558011_40390,1,73901,73901,128890,54989,54989,1054,0,0,0
128980,application_1506638472019_24463,1,27673,27673,128980,101307,101307,2623,0,0,0
128990,application_1506638472019_23263,1,27173,27173,128990,101817,101817,2559,0,0,0
129000,application_1508364558011_15353,1,45569,45569,129000,83431,83431,1656,0,0,0
129020,application_1508364558011_20959,1,50265,50265,129020,78755,78755,2001,0,0,0
129040,application_1506638472019_30435,1,30963,30963,129040,98077,98077,2065,0,0,0
129040,application_1506638472019_16230,1,23101,23101,129040,105939,105939,2770,0,0,0
129050,application_1506638472019_28467,1,29164,29164,129050,99886,99886,2307,0,0,0
129050,application_1506638472019_28075,1,29080,29080,129050,99970,99970,2360,0,0,0
129060,application_1508364558011_26151,16,58550,58550,129060,70510,70510,13038,0,0,0
129060,application_1508364558011_43656,1,77902,77902,129060,51158,51158,1324,0,0,0
129110,application_1506638472019_28930,1,29312,29312,129110,99798,99798,2427,0,0,0
129140,application_1511916184019_1708,1,99766,99766,129140,29374,29374,468,0,0,0
129160,application_1506638472019_16527,1,23162,23162,129160,105998,105998,2679,0,0,0
129170,application_1506638472019_22890,1,27001,27001,129170,102169,102169,2434,0,0,0
129200,application_1508364558011_8405,1,41641,41641,129200,87559,87559,1822,0,0,0
129260,application_1506638472019_23277,1,27175,27175,129260,102085,102085,2673,0,0,0
129270,application_1506638472019_22900,1,27003,27003,129270,102267,102267,2405,0,0,0
129320,application_1506638472019_30330,1,30951,30951,129320,98369,98369,2075,0,0,0
129330,application_1506638472019_30560,1,30997,30997,129330,98333,98333,1960,0,0,0
129330,application_1508364558011_8865,1,41849,41849,129330,87481,87481,2107,0,0,0
129350,application_1512440382012_4585,1,110005,110005,129350,19345,19345,247,0,0,0
129380,application_1506638472019_23276,1,27175,27175,129380,102205,102205,2616,0,0,0
129410,application_1513025660013_0925,1,116535,116535,129410,12875,12875,230,0,0,0
129420,application_1506638472019_28969,1,29317,29317,129420,100103,100103,2325,0,0,0
129440,application_1506638472019_23572,1,27242,27242,129440,102198,102198,2697,0,0,0
129440,application_1508364558011_1762,1,38834,38834,129440,90606,90606,2289,0,0,0
129450,application_1512440382012_3087,1,109624,109624,129450,19826,19826,1590,0,0,0
129500,application_1506638472019_22920,1,27005,27005,129500,102495,102495,2447,0,0,0
129510,application_1506638472019_16583,1,23172,23172,129510,106338,106338,2746,0,0,0
129520,application_1508364558011_40052,1,73795,73795,129520,55725,55725,883,0,0,0
129540,application_1508364558011_7484,1,41284,41284,129540,88256,88256,1853,0,0,0
129560,application_1506638472019_28438,1,29159,29159,129560,100401,100401,2305,0,0,0
129580,application_1513627406021_0400,1,118396,118396,129580,11184,11184,399,0,0,0
129660,application_1508364558011_42265,1,76153,76153,129660,53507,53507,1011,0,0,0
129660,application_1508364558011_4600,1,39799,39799,129660,89861,89861,2045,0,0,0
129670,application_1506638472019_28361,1,29148,29148,129670,100522,100522,2441,0,0,0
129680,application_1506638472019_5631,1,15900,15900,129680,113780,113780,3472,0,0,0
129710,application_1506638472019_23699,1,27261,27261,129710,102449,102449,2705,0,0,0
129710,application_1506638472019_28208,1,29105,29105,129710,100605,100605,2363,0,0,0
129800,application_1508364558011_32830,1,69100,69100,129800,60700,60700,1940,0,0,0
129800,application_1508364558011_14494,1,45101,45101,129800,84699,84699,1819,0,0,0
129900,application_1506638472019_28521,1,29184,29184,129900,100716,100716,2299,0,0,0
129920,application_1508364558011_52008,1,87978,87978,129920,41942,41942,892,0,0,0
129940,application_1506638472019_27241,1,28722,28722,129940,101218,101218,3498,0,0,0
129940,application_1508364558011_18838,1,48069,48069,129940,81871,81871,1583,0,0,0
130020,application_1508364558011_25833,4,57898,57898,130020,72122,72122,817,0,0,0
130050,application_1508364558011_9814,1,42138,42138,130050,87912,87912,1836,0,0,0
130100,application_1508364558011_34213,1,69759,69759,130100,60341,60341,1150,0,0,0
130110,application_1506638472019_28294,1,29137,29137,130110,100973,100973,2392,0,0,0
130120,application_1508364558011_1846,1,38843,38843,130120,91277,91277,1977,0,0,0
130180,application_1506638472019_28583,1,29195,29195,130180,100985,100985,2391,0,0,0
130190,application_1508364558011_10394,1,42150,42150,130190,88040,88040,1775,0,0,0
130190,application_1506638472019_23464,1,27197,27197,130190,102993,102993,2626,0,0,0
130280,application_1508364558011_5127,1,39862,39862,130280,90418,90418,1789,0,0,0
130290,application_1508364558011_9337,1,42062,42062,130290,88228,88228,1929,0,0,0
130320,application_1508364558011_4643,1,39802,39802,130320,90518,90518,2007,0,0,0
130330,application_1506638472019_27821,1,29045,29045,130330,101285,101285,2322,0,0,0
130340,application_1506638472019_16533,1,23163,23163,130340,107177,107177,2838,0,0,0
130360,application_1512440382012_6703,1,114879,114879,130360,15481,15481,287,0,0,0
130410,application_1508364558011_1769,1,38834,38834,130410,91576,91576,1967,0,0,0
130420,application_1508364558011_24437,1,56911,56911,130420,73509,73509,1471,0,0,0
130430,application_1508364558011_34651,1,69783,69783,130430,60647,60647,1940,0,0,0
130470,application_1506638472019_23423,1,27193,27193,130470,103277,103277,2869,0,0,0
130500,application_1506638472019_16516,1,23160,23160,130500,107340,107340,2773,0,0,0
130500,application_1506638472019_16770,1,23288,23288,130500,107212,107212,2832,0,0,0
130510,application_1508364558011_2219,1,39001,39001,130510,91509,91509,1663,0,0,0
130540,application_1506638472019_24247,1,27374,27374,130540,103166,103166,2816,0,0,0
130550,application_1512440382012_1381,1,107468,107468,130550,23082,23082,452,0,0,0
130550,application_1508364558011_24780,1,57371,57371,130550,73179,73179,1342,0,0,0
130560,application_1508364558011_16095,1,46389,46389,130560,84171,84171,1759,0,0,0
130570,application_1508364558011_15358,1,45569,45569,130570,85001,85001,2011,0,0,0
130580,application_1508364558011_32037,1,68420,68420,130580,62160,62160,1743,0,0,0
130620,application_1508364558011_3134,1,39204,39204,130620,91416,91416,2140,0,0,0
130660,application_1506638472019_23407,1,27190,27190,130660,103470,103470,2584,0,0,0
130690,application_1506638472019_28547,1,29188,29188,130690,101502,101502,2391,0,0,0
130730,application_1513025660013_0006,1,114963,114963,130730,15767,15767,258,0,0,0
130770,application_1506638472019_28436,1,29159,29159,130770,101611,101611,2412,0,0,0
130790,application_1506638472019_28358,1,29147,29147,130790,101643,101643,2380,0,0,0
130900,application_1506638472019_18452,1,24597,24597,130900,106303,106303,3582,0,0,0
130920,application_1508364558011_12177,1,43506,43506,130920,87414,87414,1634,0,0,0
131040,application_1508364558011_5608,1,40037,40037,131040,91003,91003,2023,0,0,0
131080,application_1506638472019_25655,1,27862,27862,131080,103218,103218,2695,0,0,0
131090,application_1508364558011_5016,1,39860,39860,131090,91230,91230,2355,0,0,0
131110,application_1508364558011_27896,1,62056,62056,131110,69054,69054,1417,0,0,0
131200,application_1506638472019_28977,1,29319,29319,131200,101881,101881,2276,0,0,0
131240,application_1508364558011_8108,1,41624,41624,131240,89616,89616,1762,0,0,0
131240,application_1513025660013_0968,1,116653,116653,131240,14587,14587,321,0,0,0
131300,application_1508364558011_2127,1,38993,38993,131300,92307,92307,1969,0,0,0
131300,application_1506638472019_28503,1,29181,29181,131300,102119,102119,2360,0,0,0
131310,application_1512440382012_4956,1,110171,110171,131310,21139,21139,790,0,0,0
131310,application_1508364558011_19679,1,49113,49113,131310,82197,82197,1587,0,0,0
131330,application_1506638472019_16712,1,23276,23276,131330,108054,108054,2816,0,0,0
131330,application_1508364558011_32558,1,68749,68749,131330,62581,62581,1989,0,0,0
131350,application_1506638472019_22930,1,27006,27006,131350,104344,104344,2459,0,0,0
131370,application_1508364558011_35039,1,69882,69882,131370,61488,61488,2077,0,0,0
131400,application_1506638472019_8305,1,17386,17386,131400,114014,114014,3830,0,0,0
131450,application_1506638472019_23314,1,27179,27179,131450,104271,104271,2716,0,0,0
131480,application_1506638472019_23517,1,27203,27203,131480,104277,104277,2608,0,0,0
131500,application_1506638472019_27173,1,28714,28714,131500,102786,102786,3550,0,0,0
131500,application_1506638472019_16438,1,23145,23145,131500,108355,108355,2753,0,0,0
131520,application_1508364558011_40326,1,73896,73896,131520,57624,57624,1346,0,0,0
131530,application_1506638472019_23114,1,27160,27160,131530,104370,104370,2689,0,0,0
131590,application_1506638472019_30444,1,30964,30964,131590,100626,100626,1922,0,0,0
131690,application_1508364558011_37328,1,72294,72294,131690,59396,59396,1117,0,0,0
131750,application_1508364558011_8011,1,41622,41622,131750,90128,90128,1971,0,0,0
131810,application_1506638472019_25579,1,27854,27854,131810,103956,103956,2655,0,0,0
131830,application_1508364558011_43556,1,77894,77894,131830,53936,53936,940,0,0,0
131830,application_1513627406021_1405,1,120668,120668,131830,11162,11162,347,0,0,0
131860,application_1508364558011_6740,1,40814,40814,131860,91046,91046,2482,0,0,0
131870,application_1508364558011_6472,1,40810,40810,131870,91060,91060,2042,0,0,0
131870,application_1506638472019_28380,1,29151,29151,131870,102719,102719,2343,0,0,0
131920,application_1508364558011_36426,4,70700,70700,131920,61220,61220,1480,0,0,0
131930,application_1508364558011_26123,1,58513,58513,131930,73417,73417,2079,0,0,0
131950,application_1506638472019_16225,1,23100,23100,131950,108850,108850,2772,0,0,0
131950,application_1513025660013_0826,1,116343,116343,131950,15607,15607,273,0,0,0
132010,application_1508364558011_4053,1,39358,39358,132010,92652,92652,2396,0,0,0
132020,application_1508364558011_6479,1,40810,40810,132020,91210,91210,1940,0,0,0
132050,application_1506638472019_25663,1,27863,27863,132050,104187,104187,2655,0,0,0
132050,application_1512440382012_3190,1,109646,109646,132050,22404,22404,549,0,0,0
132060,application_1506638472019_17097,1,23347,23347,132060,108713,108713,2869,0,0,0
132080,application_1513025660013_0096,1,115088,115088,132080,16992,16992,498,0,0,0
132100,application_1506638472019_28133,1,29088,29088,132100,103012,103012,2314,0,0,0
132130,application_1508364558011_52888,1,89434,89434,132130,42696,42696,799,0,0,0
132140,application_1512440382012_3185,1,109645,109645,132140,22495,22495,552,0,0,0
132160,application_1506638472019_16843,1,23301,23301,132160,108859,108859,2803,0,0,0
132210,application_1506638472019_23256,1,27172,27172,132210,105038,105038,2600,0,0,0
132250,application_1506638472019_28491,1,29179,29179,132250,103071,103071,2297,0,0,0
132260,application_1508364558011_4420,1,39366,39366,132260,92894,92894,1922,0,0,0
132260,application_1508364558011_3200,1,39213,39213,132260,93047,93047,1828,0,0,0
132310,application_1506638472019_28626,1,29201,29201,132310,103109,103109,2317,0,0,0
132310,application_1508364558011_29238,4,65459,65459,132310,66851,66851,629,0,0,0
132320,application_1504131676014_20212,1,2460,2460,132320,129860,129860,11288,0,0,0
132320,application_1506638472019_22332,1,26542,26542,132320,105778,105778,2536,0,0,0
132330,application_1512440382012_2121,1,108663,108663,132330,23667,23667,642,0,0,0
132400,application_1512440382012_3275,1,109660,109660,132400,22740,22740,555,0,0,0
132410,application_1508364558011_8392,1,41641,41641,132410,90769,90769,1892,0,0,0
132410,application_1508364558011_15054,1,45565,45565,132410,86845,86845,2046,0,0,0
132450,application_1506638472019_27818,1,29044,29044,132450,103406,103406,2409,0,0,0
132460,application_1506638472019_31010,1,31074,31074,132460,101386,101386,2045,0,0,0
132530,application_1506638472019_30620,1,31004,31004,132530,101526,101526,2006,0,0,0
132530,application_1506638472019_22394,1,26561,26561,132530,105969,105969,2541,0,0,0
132540,application_1508364558011_4616,1,39800,39800,132540,92740,92740,2257,0,0,0
132560,application_1508364558011_47170,1,80269,80269,132560,52291,52291,889,0,0,0
132610,application_1508364558011_7075,1,41193,41193,132610,91417,91417,1744,0,0,0
132650,application_1506638472019_16240,1,23104,23104,132650,109546,109546,2788,0,0,0
132710,application_1508364558011_9702,1,42136,42136,132710,90574,90574,2774,0,0,0
132750,application_1508364558011_24400,1,56906,56906,132750,75844,75844,1598,0,0,0
132760,application_1506638472019_24127,1,27344,27344,132760,105416,105416,2584,0,0,0
132770,application_1508364558011_40857,1,74451,74451,132770,58319,58319,1481,0,0,0
132770,application_1506638472019_22114,1,26517,26517,132770,106253,106253,2522,0,0,0
132770,application_1506638472019_5096,1,15816,15816,132770,116954,116954,4055,0,0,0
132820,application_1508364558011_1776,1,38835,38835,132820,93985,93985,1985,0,0,0
132820,application_1506638472019_23220,1,27168,27168,132820,105652,105652,2577,0,0,0
132890,application_1508364558011_21109,1,50500,50500,132890,82390,82390,1594,0,0,0
132910,application_1506638472019_16159,1,23087,23087,132910,109823,109823,2815,0,0,0
133000,application_1512440382012_2835,1,109588,109588,133000,23412,23412,651,0,0,0
133030,application_1513025660013_0920,1,116535,116535,133030,16495,16495,378,0,0,0
133030,application_1508364558011_10019,1,42141,42141,133030,90889,90889,2039,0,0,0
133050,application_1508364558011_10076,1,42144,42144,133050,90906,90906,1788,0,0,0
133060,application_1506638472019_17047,1,23338,23338,133060,109722,109722,2845,0,0,0
133120,application_1506638472019_5767,1,15905,15905,133120,117215,117215,4081,0,0,0
133130,application_1508364558011_34552,1,69781,69781,133130,63349,63349,1715,0,0,0
133190,application_1506638472019_20038,1,25133,25133,133190,108057,108057,2849,0,0,0
133200,application_1506638472019_16251,1,23106,23106,133200,110094,110094,2844,0,0,0
133220,application_1511916184019_1232,1,99171,99171,133220,34049,34049,701,0,0,0
133220,application_1506638472019_23240,1,27170,27170,133220,106050,106050,2693,0,0,0
133240,application_1508364558011_31900,1,68394,68394,133240,64846,64846,1637,0,0,0
133290,application_1508364558011_49019,1,85072,85072,133290,48218,48218,2514,0,0,0
133300,application_1513627406021_2081,1,121959,121959,133300,11341,11341,191,0,0,0
133330,application_1508364558011_20964,1,50265,50265,133330,83065,83065,1764,0,0,0
133350,application_1508364558011_49171,1,85240,85240,133350,48110,48110,867,0,0,0
133360,application_1508364558011_32916,1,69229,69229,133360,64131,64131,1639,0,0,0
133390,application_1506638472019_16989,1,23326,23326,133390,110064,110064,2865,0,0,0
133410,application_1508364558011_7072,1,41192,41192,133410,92218,92218,1866,0,0,0
133420,application_1508364558011_11403,4,43190,43190,133420,90230,90230,676,0,0,0
133460,application_1508364558011_49704,1,86200,86200,133460,47260,47260,870,0,0,0
133470,application_1506638472019_28517,1,29182,29182,133470,104288,104288,2410,0,0,0
133500,application_1506638472019_16745,1,23283,23283,133500,110217,110217,2738,0,0,0
133550,application_1512440382012_3227,1,109653,109653,133550,23897,23897,574,0,0,0
133550,application_1506638472019_16970,1,23323,23323,133550,110227,110227,2821,0,0,0
133590,application_1508364558011_15326,1,45569,45569,133590,88021,88021,2583,0,0,0
133600,application_1508364558011_32255,1,68568,68568,133600,65032,65032,1478,0,0,0
133620,application_1506638472019_28369,1,29149,29149,133620,104471,104471,2384,0,0,0
133650,application_1508364558011_9318,1,42061,42061,133650,91589,91589,2014,0,0,0
133670,application_1508364558011_8029,1,41622,41622,133670,92048,92048,1844,0,0,0
133720,application_1508364558011_34704,1,69784,69784,133720,63936,63936,1476,0,0,0
133720,application_1508364558011_8408,1,41641,41641,133720,92079,92079,2020,0,0,0
133730,application_1508364558011_9300,1,42061,42061,133730,91669,91669,1737,0,0,0
133760,application_1506638472019_26185,1,28065,28065,133760,105695,105695,5073,0,0,0
133770,application_1512440382012_2826,1,109587,109587,133770,24183,24183,632,0,0,0
133780,application_1506638472019_4903,1,15807,15807,133780,117973,117973,4074,0,0,0
133790,application_1508364558011_4975,1,39859,39859,133790,93931,93931,1913,0,0,0
133820,application_1506638472019_11683,1,18770,18770,133820,115050,115050,3002,0,0,0
133830,application_1506638472019_27455,1,28747,28747,133830,105083,105083,3496,0,0,0
133830,application_1508364558011_19393,1,48801,48801,133830,85029,85029,1715,0,0,0
133850,application_1508364558011_4564,1,39799,39799,133850,94051,94051,2021,0,0,0
133950,application_1506638472019_28607,1,29199,29199,133950,104751,104751,2415,0,0,0
133960,application_1506638472019_24165,1,27353,27353,133960,106607,106607,2619,0,0,0
133970,application_1506638472019_28712,1,29214,29214,133970,104756,104756,2428,0,0,0
134030,application_1508364558011_4149,1,39361,39361,134030,94669,94669,2017,0,0,0
134040,application_1506638472019_25610,1,27857,27857,134040,106183,106183,2619,0,0,0
134050,application_1506638472019_23641,1,27252,27252,134050,106798,106798,2533,0,0,0
134050,application_1506638472019_7990,1,17278,17278,134050,116772,116772,3438,0,0,0
134150,application_1508364558011_5058,1,39861,39861,134150,94289,94289,1982,0,0,0
134170,application_1508364558011_8005,1,41622,41622,134170,92548,92548,1899,0,0,0
134170,application_1508364558011_8833,1,41848,41848,134170,92322,92322,2089,0,0,0
134220,application_1508364558011_14861,1,45378,45378,134220,88842,88842,1934,0,0,0
134270,application_1508364558011_35047,1,69882,69882,134270,64388,64388,1301,0,0,0
134270,application_1508364558011_2430,1,39012,39012,134270,95258,95258,1946,0,0,0
134340,application_1508364558011_15108,1,45565,45565,134340,88775,88775,2028,0,0,0
134340,application_1508364558011_12618,1,43587,43587,134340,90753,90753,1978,0,0,0
134350,application_1508364558011_30805,1,67126,67126,134350,67224,67224,2050,0,0,0
134360,application_1508364558011_9740,1,42137,42137,134360,92223,92223,2126,0,0,0
134410,application_1508364558011_4945,1,39811,39811,134410,94599,94599,1952,0,0,0
134470,application_1506638472019_10351,1,18318,18318,134470,116152,116152,3345,0,0,0
134510,application_1506638472019_5782,1,15906,15906,134510,118604,118604,4022,0,0,0
134530,application_1511528684064_0723,1,93777,93777,134530,40753,40753,955,0,0,0
134560,application_1508364558011_5562,1,40037,40037,134560,94523,94523,2103,0,0,0
134570,application_1508364558011_49372,1,85517,85517,134570,49053,49053,852,0,0,0
134580,application_1506638472019_22243,1,26532,26532,134580,108048,108048,2556,0,0,0
134620,application_1506638472019_5137,1,15817,15817,134620,118803,118803,3979,0,0,0
134630,application_1508364558011_12634,1,43588,43588,134630,91042,91042,2379,0,0,0
134630,application_1508364558011_40335,1,73897,73897,134630,60733,60733,1141,0,0,0
134640,application_1512440382012_3249,1,109656,109656,134640,24984,24984,575,0,0,0
134700,application_1506638472019_16806,1,23295,23295,134700,111405,111405,2865,0,0,0
134760,application_1506638472019_5835,1,15969,15969,134760,118791,118791,6077,0,0,0
134840,application_1511916184019_3253,1,104218,104218,134840,30622,30622,724,0,0,0
134850,application_1512440382012_2848,1,109590,109590,134850,25260,25260,626,0,0,0
134860,application_1506638472019_16964,1,23322,23322,134860,111538,111538,2983,0,0,0
134860,application_1506638472019_10860,1,18651,18651,134860,116209,116209,3035,0,0,0
134880,application_1506638472019_28477,1,29167,29167,134880,105713,105713,2458,0,0,0
134940,application_1508364558011_34646,1,69783,69783,134940,65157,65157,1487,0,0,0
134960,application_1506638472019_28313,1,29139,29139,134960,105821,105821,2388,0,0,0
134970,application_1508364558011_7010,1,41187,41187,134970,93783,93783,1906,0,0,0
135000,application_1506638472019_5218,1,15819,15819,135000,119181,119181,3957,0,0,0
135060,application_1506638472019_16768,1,23287,23287,135060,111773,111773,2805,0,0,0
135060,application_1508364558011_35075,1,69883,69883,135060,65177,65177,1579,0,0,0
135080,application_1508364558011_8773,1,41648,41648,135080,93432,93432,2118,0,0,0
135110,application_1508364558011_7485,1,41284,41284,135110,93826,93826,1859,0,0,0
135160,application_1512440382012_2834,1,109588,109588,135160,25572,25572,656,0,0,0
135230,application_1512440382012_2842,1,109590,109590,135230,25640,25640,631,0,0,0
135230,application_1512440382012_1932,1,108367,108367,135230,26863,26863,1460,0,0,0
135380,application_1506638472019_23451,1,27195,27195,135380,108185,108185,2564,0,0,0
135390,application_1512440382012_5390,1,110636,110636,135390,24754,24754,1019,0,0,0
135400,application_1506638472019_22911,1,27004,27004,135400,108396,108396,2530,0,0,0
135400,application_1508364558011_5573,1,40037,40037,135400,95363,95363,1756,0,0,0
135440,application_1506638472019_23590,1,27245,27245,135440,108195,108195,2756,0,0,0
135440,application_1508364558011_8349,1,41627,41627,135440,93813,93813,1888,0,0,0
135500,application_1506638472019_23318,1,27180,27180,135500,108320,108320,2597,0,0,0
135510,application_1506638472019_5453,1,15894,15894,135510,119616,119616,4023,0,0,0
135550,application_1508364558011_8035,1,41622,41622,135550,93928,93928,1935,0,0,0
135560,application_1508364558011_33917,1,69705,69705,135560,65855,65855,1361,0,0,0
135560,application_1506638472019_19146,1,24837,24837,135560,110723,110723,4993,0,0,0
135560,application_1506638472019_28523,1,29184,29184,135560,106376,106376,2282,0,0,0
135580,application_1508364558011_36946,1,71793,71793,135580,63787,63787,1353,0,0,0
135600,application_1506638472019_22952,1,27008,27008,135600,108592,108592,2578,0,0,0
135610,application_1511528684064_0924,1,94243,94243,135610,41367,41367,2677,0,0,0
135610,application_1508364558011_7402,1,41282,41282,135610,94328,94328,2010,0,0,0
135620,application_1506638472019_5484,1,15895,15895,135620,119725,119725,3478,0,0,0
135620,application_1508364558011_42772,1,76702,76702,135620,58918,58918,1665,0,0,0
135650,application_1508364558011_52042,1,88029,88029,135650,47621,47621,925,0,0,0
135690,application_1508364558011_32632,16,68807,68807,135690,66883,66883,8846,0,0,0
135720,application_1508364558011_8315,1,41627,41627,135720,94093,94093,1930,0,0,0
135730,application_1506638472019_23180,1,27165,27165,135730,108565,108565,2624,0,0,0
135780,application_1506638472019_28629,1,29202,29202,135780,106578,106578,2407,0,0,0
135840,application_1506638472019_23202,1,27167,27167,135840,108673,108673,2540,0,0,0
135950,application_1512440382012_2818,1,109586,109586,135950,26364,26364,633,0,0,0
135960,application_1508364558011_20394,1,49637,49637,135960,86323,86323,2272,0,0,0
135990,application_1508364558011_4632,1,39801,39801,135990,96189,96189,1990,0,0,0
136060,application_1506638472019_28913,1,29310,29310,136060,106750,106750,2356,0,0,0
136160,application_1508364558011_3412,1,39230,39230,136160,96930,96930,2102,0,0,0
136160,application_1506638472019_16215,1,23099,23099,136160,113061,113061,2800,0,0,0
136170,application_1506638472019_28422,1,29157,29157,136170,107013,107013,2372,0,0,0
136190,application_1506638472019_17095,1,23347,23347,136190,112843,112843,2623,0,0,0
136300,application_1508364558011_15365,1,45569,45569,136300,90731,90731,1853,0,0,0
136320,application_1511916184019_3280,1,104261,104261,136320,32059,32059,739,0,0,0
136370,application_1506638472019_29242,1,29817,29817,136370,106553,106553,2442,0,0,0
136450,application_1506638472019_16414,1,23139,23139,136450,113311,113311,2744,0,0,0
136490,application_1506638472019_17140,1,23356,23356,136490,113134,113134,2734,0,0,0
136560,application_1506638472019_28130,1,29087,29087,136560,107473,107473,3679,0,0,0
136560,application_1512440382012_1062,1,106789,106789,136560,29771,29771,702,0,0,0
136580,application_1512440382012_3685,1,109732,109732,136580,26848,26848,657,0,0,0
136640,application_1506638472019_18845,1,24778,24778,136640,111862,111862,3948,0,0,0
136660,application_1508364558011_34579,1,69782,69782,136660,66878,66878,1371,0,0,0
136680,application_1508364558011_35150,1,69884,69884,136680,66796,66796,1665,0,0,0
136690,application_1512440382012_2793,1,109581,109581,136690,27109,27109,639,0,0,0
136710,application_1508364558011_9748,1,42137,42137,136710,94573,94573,2632,0,0,0
136720,application_1512440382012_6492,1,114316,114316,136720,22404,22404,726,0,0,0
136730,application_1508364558011_24444,1,56911,56911,136730,79819,79819,1447,0,0,0
136730,application_1508364558011_36483,1,70773,70773,136730,65957,65957,1505,0,0,0
136750,application_1506638472019_28878,1,29304,29304,136750,107446,107446,2458,0,0,0
136820,application_1506638472019_28004,1,29074,29074,136820,107746,107746,2460,0,0,0
136890,application_1506638472019_23650,1,27253,27253,136890,109637,109637,2703,0,0,0
136890,application_1508364558011_3790,1,39290,39290,136890,97600,97600,2207,0,0,0
136960,application_1508364558011_32391,1,68625,68625,136960,68335,68335,1590,0,0,0
136990,application_1508364558011_10100,1,42145,42145,136990,94845,94845,2058,0,0,0
137010,application_1508364558011_9984,1,42140,42140,137010,94870,94870,2347,0,0,0
137030,application_1512440382012_0744,1,106346,106346,137030,30684,30684,802,0,0,0
137100,application_1508364558011_19386,1,48800,48800,137100,88300,88300,1696,0,0,0
137130,application_1506638472019_24512,1,27696,27696,137130,109434,109434,2605,0,0,0
137170,application_1506638472019_17061,1,23341,23341,137170,113829,113829,2894,0,0,0
137180,application_1506638472019_16694,1,23273,23273,137180,113907,113907,2794,0,0,0
137200,application_1506638472019_24105,1,27342,27342,137200,109858,109858,2706,0,0,0
137200,application_1508364558011_7100,1,41277,41277,137200,95923,95923,1975,0,0,0
137280,application_1512440382012_5394,1,110640,110640,137280,26640,26640,1060,0,0,0
137340,application_1508364558011_33960,1,69712,69712,137340,67628,67628,1363,0,0,0
137340,application_1508364558011_8031,1,41622,41622,137340,95718,95718,2041,0,0,0
137370,application_1506638472019_25510,1,27845,27845,137370,109525,109525,2806,0,0,0
137390,application_1508364558011_26101,1,58467,58467,137390,78923,78923,1512,0,0,0
137480,application_1508364558011_4992,1,39859,39859,137480,97621,97621,2468,0,0,0
137500,application_1506638472019_24144,1,27347,27347,137500,110153,110153,2960,0,0,0
137510,application_1508364558011_8491,1,41642,41642,137510,95868,95868,2020,0,0,0
137540,application_1508364558011_7102,1,41277,41277,137540,96263,96263,2631,0,0,0
137600,application_1508364558011_3349,1,39221,39221,137600,98379,98379,2327,0,0,0
137610,application_1512440382012_2799,1,109582,109582,137610,28028,28028,661,0,0,0
137610,application_1512440382012_2885,1,109594,109594,137610,28016,28016,663,0,0,0
137680,application_1506638472019_25529,1,27848,27848,137680,109832,109832,2634,0,0,0
137700,application_1506638472019_23714,1,27263,27263,137700,110437,110437,2652,0,0,0
137700,application_1508364558011_3147,1,39206,39206,137700,98494,98494,2095,0,0,0
137710,application_1512440382012_0382,1,105656,105656,137710,32054,32054,825,0,0,0
137720,application_1506638472019_29221,1,29814,29814,137720,107906,107906,2421,0,0,0
137720,application_1506638472019_23692,1,27260,27260,137720,110460,110460,2620,0,0,0
137750,application_1506638472019_4817,1,15799,15799,137750,121951,121951,3545,0,0,0
137770,application_1506638472019_22877,1,27000,27000,137770,110770,110770,2576,0,0,0
137770,application_1508364558011_4663,1,39803,39803,137770,97967,97967,2495,0,0,0
137780,application_1508364558011_5553,1,40036,40036,137780,97744,97744,2018,0,0,0
137790,application_1508364558011_4573,1,39799,39799,137790,97991,97991,2322,0,0,0
137810,application_1504131676014_25285,1,8492,8492,137810,129318,129318,7529,0,0,0
137880,application_1508364558011_6768,1,40815,40815,137880,97065,97065,2265,0,0,0
137960,application_1506638472019_16798,1,23293,23293,137960,114667,114667,2937,0,0,0
137980,application_1506638472019_4908,1,15807,15807,137980,122173,122173,3981,0,0,0
137990,application_1508364558011_7183,1,41278,41278,137990,96712,96712,2121,0,0,0
138010,application_1508364558011_3303,1,39219,39219,138010,98791,98791,2460,0,0,0
138010,application_1508364558011_4683,1,39803,39803,138010,98207,98207,2587,0,0,0
138030,application_1508364558011_45554,1,78350,78350,138030,59680,59680,1473,0,0,0
138080,application_1506638472019_28316,1,29140,29140,138080,108940,108940,2822,0,0,0
138080,application_1506638472019_5007,1,15812,15812,138080,122268,122268,4059,0,0,0
138100,application_1506638472019_24111,1,27342,27342,138100,110758,110758,2773,0,0,0
138100,application_1506638472019_26216,1,28075,28075,138100,110025,110025,2523,0,0,0
138140,application_1506638472019_17178,1,23364,23364,138140,114776,114776,2764,0,0,0
138160,application_1513025660013_0001,8,114960,114960,138160,23200,23200,416,0,0,0
138170,application_1506638472019_23533,1,27205,27205,138170,110965,110965,2597,0,0,0
138180,application_1506638472019_4885,1,15805,15805,138180,122375,122375,3973,0,0,0
138210,application_1506638472019_21784,1,26327,26327,138210,111883,111883,2573,0,0,0
138230,application_1508364558011_49492,1,85840,85840,138230,52390,52390,2718,0,0,0
138250,application_1506638472019_24232,1,27371,27371,138250,110879,110879,2627,0,0,0
138280,application_1508364558011_21333,1,50723,50723,138280,87557,87557,1954,0,0,0
138320,application_1508364558011_3613,1,39252,39252,138320,99068,99068,2643,0,0,0
138380,application_1508364558011_33934,1,69712,69712,138380,68668,68668,1496,0,0,0
138410,application_1506638472019_27925,1,29061,29061,138410,109349,109349,2417,0,0,0
138410,application_1508364558011_30738,1,67120,67120,138410,71290,71290,2530,0,0,0
138430,application_1508364558011_2149,1,38995,38995,138430,99435,99435,2177,0,0,0
138440,application_1506638472019_23442,1,27195,27195,138440,111245,111245,2670,0,0,0
138470,application_1508364558011_32379,1,68623,68623,138470,69847,69847,1663,0,0,0
138480,application_1506638472019_23431,1,27193,27193,138480,111287,111287,2554,0,0,0
138490,application_1506638472019_27322,1,28731,28731,138490,109759,109759,3418,0,0,0
138540,application_1508364558011_9780,1,42137,42137,138540,96403,96403,2020,0,0,0
138550,application_1508364558011_9137,1,41853,41853,138550,96697,96697,2004,0,0,0
138580,application_1508364558011_15373,1,45569,45569,138580,93011,93011,1930,0,0,0
138640,application_1506638472019_4953,1,15809,15809,138640,122831,122831,3685,0,0,0
138670,application_1506638472019_27320,1,28731,28731,138670,109939,109939,3369,0,0,0
138720,application_1508364558011_34040,1,69721,69721,138720,68999,68999,1463,0,0,0
138730,application_1508364558011_30490,1,67011,67011,138730,71719,71719,1577,0,0,0
138790,application_1508364558011_20840,1,50172,50172,138790,88618,88618,2256,0,0,0
138900,application_1506638472019_23447,1,27195,27195,138900,111705,111705,2731,0,0,0
138910,application_1508364558011_8917,1,41849,41849,138910,97061,97061,2161,0,0,0
138920,application_1506638472019_16235,1,23102,23102,138920,115818,115818,2832,0,0,0
138920,application_1511916184019_0409,1,97405,97405,138920,41515,41515,964,0,0,0
139050,application_1508364558011_34773,1,69785,69785,139050,69265,69265,1495,0,0,0
139060,application_1506638472019_4964,1,15810,15810,139060,123250,123250,3963,0,0,0
139070,application_1506638472019_16743,1,23282,23282,139070,115788,115788,3088,0,0,0
139100,application_1512440382012_2812,1,109584,109584,139100,29516,29516,659,0,0,0
139160,application_1506638472019_5666,1,15901,15901,139160,123259,123259,3636,0,0,0
139200,application_1508364558011_5310,1,39869,39869,139200,99331,99331,2298,0,0,0
139210,application_1506638472019_24295,1,27389,27389,139210,111821,111821,2675,0,0,0
139240,application_1508364558011_41662,1,75244,75244,139240,63996,63996,1405,0,0,0
139290,application_1508364558011_39978,1,73789,73789,139290,65501,65501,1395,0,0,0
139340,application_1506638472019_16301,1,23116,23116,139340,116224,116224,2811,0,0,0
139400,application_1508364558011_20658,1,49957,49957,139400,89443,89443,2173,0,0,0
139520,application_1512440382012_2804,1,109583,109583,139520,29937,29937,737,0,0,0
139530,application_1506638472019_5073,1,15814,15814,139530,123716,123716,4109,0,0,0
139580,application_1506638472019_28043,1,29077,29077,139580,110503,110503,2380,0,0,0
139620,application_1511528684064_1136,1,94824,94824,139620,44796,44796,940,0,0,0
139650,application_1508364558011_4584,1,39799,39799,139650,99851,99851,2086,0,0,0
139660,application_1506638472019_16245,1,23105,23105,139660,116555,116555,2850,0,0,0
139750,application_1506638472019_34679,1,34629,34629,139750,105121,105121,3036,0,0,0
139750,application_1508364558011_14862,1,45379,45379,139750,94371,94371,1957,0,0,0
139780,application_1513627406021_2164,1,122208,122208,139780,17572,17572,618,0,0,0
139790,application_1508364558011_33459,1,69462,69462,139790,70328,70328,1555,0,0,0
139840,application_1508364558011_29366,1,65900,65900,139840,73940,73940,1428,0,0,0
139860,application_1506638472019_24192,1,27364,27364,139860,112496,112496,2678,0,0,0
139880,application_1508364558011_21515,1,50729,50729,139880,89151,89151,2143,0,0,0
139890,application_1512440382012_2501,1,109116,109116,139890,30774,30774,923,0,0,0
139900,application_1506638472019_5554,1,15897,15897,139900,124003,124003,3991,0,0,0
139960,application_1508364558011_6565,1,40812,40812,139960,99148,99148,1937,0,0,0
140020,application_1506638472019_16809,1,23295,23295,140020,116725,116725,2914,0,0,0
140030,application_1506638472019_27026,1,28695,28695,140030,111335,111335,3355,0,0,0
140130,application_1506638472019_18781,1,24659,24659,140130,115471,115471,3575,0,0,0
140190,application_1508364558011_19402,1,48801,48801,140190,91389,91389,1970,0,0,0
140300,application_1506638472019_23393,1,27188,27188,140300,113112,113112,2816,0,0,0
140340,application_1508364558011_9769,1,42137,42137,140340,98203,98203,2557,0,0,0
140440,application_1508364558011_9766,1,42137,42137,140440,98303,98303,1992,0,0,0
140460,application_1508364558011_15319,1,45569,45569,140460,94891,94891,2098,0,0,0
140480,application_1508364558011_6792,1,40815,40815,140480,99665,99665,2347,0,0,0
140490,application_1508364558011_31925,1,68407,68407,140490,72083,72083,1559,0,0,0
140550,application_1506638472019_28394,1,29153,29153,140550,111397,111397,2331,0,0,0
140600,application_1508364558011_21486,1,50728,50728,140600,89872,89872,2041,0,0,0
140750,application_1506638472019_8221,1,17304,17304,140750,123446,123446,3543,0,0,0
140770,application_1508364558011_9296,1,42061,42061,140770,98709,98709,2017,0,0,0
140770,application_1512440382012_3241,1,109655,109655,140770,31115,31115,837,0,0,0
140780,application_1512440382012_1283,1,107202,107202,140780,33578,33578,927,0,0,0
140790,application_1508364558011_39549,1,73751,73751,140790,67039,67039,1767,0,0,0
140790,application_1508364558011_10114,1,42145,42145,140790,98645,98645,2119,0,0,0
140870,application_1508364558011_8068,1,41623,41623,140870,99247,99247,2616,0,0,0
140920,application_1508364558011_32274,1,68577,68577,140920,72343,72343,1949,0,0,0
140930,application_1513627406021_2355,1,122363,122363,140930,18567,18567,670,0,0,0
140930,application_1508364558011_42744,1,76698,76698,140930,64232,64232,1559,0,0,0
140960,application_1506638472019_26867,1,28593,28593,140960,112367,112367,3435,0,0,0
140970,application_1513627406021_2324,1,122315,122315,140970,18655,18655,555,0,0,0
140980,application_1508364558011_7720,1,41514,41514,140980,99466,99466,2276,0,0,0
141000,application_1512440382012_0985,1,106664,106664,141000,34336,34336,896,0,0,0
141010,application_1508364558011_34741,1,69784,69784,141010,71226,71226,2522,0,0,0
141050,application_1506638472019_4912,1,15807,15807,141050,125243,125243,4037,0,0,0
141050,application_1508364558011_4665,1,39803,39803,141050,101247,101247,2234,0,0,0
141110,application_1508364558011_3163,1,39208,39208,141110,101902,101902,2152,0,0,0
141190,application_1506638472019_7735,1,17253,17253,141190,123937,123937,3751,0,0,0
141220,application_1508364558011_4176,1,39361,39361,141220,101859,101859,2362,0,0,0
141220,application_1506638472019_7255,1,17167,17167,141220,124053,124053,4449,0,0,0
141240,application_1512440382012_2786,1,109580,109580,141240,31660,31660,648,0,0,0
141280,application_1506638472019_24095,1,27341,27341,141280,113939,113939,2726,0,0,0
141300,application_1506638472019_23587,1,27244,27244,141300,114056,114056,2686,0,0,0
141340,application_1506638472019_5511,1,15896,15896,141340,125444,125444,3960,0,0,0
141350,application_1506638472019_23529,1,27205,27205,141350,114145,114145,2803,0,0,0
141370,application_1513627406021_2271,1,122223,122223,141370,19147,19147,647,0,0,0
141440,application_1506638472019_28283,1,29136,29136,141440,112304,112304,2408,0,0,0
141490,application_1508364558011_32715,1,68953,68953,141490,72537,72537,2288,0,0,0
141510,application_1508364558011_35170,1,69884,69884,141510,71626,71626,2189,0,0,0
141630,application_1508364558011_31874,1,68375,68375,141630,73255,73255,1758,0,0,0
141650,application_1506638472019_5830,1,15969,15969,141650,125681,125681,4028,0,0,0
141650,application_1512440382012_2921,1,109597,109597,141650,32053,32053,649,0,0,0
141700,application_1508364558011_34064,1,69723,69723,141700,71977,71977,1160,0,0,0
141700,application_1506638472019_26785,1,28576,28576,141700,113124,113124,3378,0,0,0
141720,application_1506638472019_17841,1,24495,24495,141720,117225,117225,3324,0,0,0
141730,application_1508364558011_33635,1,69531,69531,141730,72199,72199,1434,0,0,0
141730,application_1508364558011_33896,1,69699,69699,141730,72031,72031,1427,0,0,0
141750,application_1506638472019_23411,1,27191,27191,141750,114559,114559,2685,0,0,0
141760,application_1508364558011_34587,1,69782,69782,141760,71978,71978,1892,0,0,0
141800,application_1513627406021_2407,1,122364,122364,141800,19436,19436,601,0,0,0
141830,application_1512440382012_6490,1,114307,114307,141830,27523,27523,597,0,0,0
141860,application_1508364558011_29423,1,65961,65961,141860,75899,75899,1738,0,0,0
141880,application_1506638472019_23619,1,27249,27249,141880,114631,114631,2598,0,0,0
141890,application_1508364558011_20640,1,49916,49916,141890,91974,91974,2141,0,0,0
141960,application_1506638472019_28466,1,29164,29164,141960,112796,112796,2444,0,0,0
142000,application_1506638472019_27937,1,29063,29063,142000,112937,112937,2379,0,0,0
142010,application_1508364558011_36479,1,70768,70768,142010,71242,71242,2667,0,0,0
142100,application_1512440382012_4124,1,109883,109883,142100,32217,32217,640,0,0,0
142120,application_1508364558011_20908,1,50264,50264,142120,91856,91856,2262,0,0,0
142130,application_1513627406021_2186,1,122212,122212,142130,19918,19918,739,0,0,0
142140,application_1508364558011_9328,1,42061,42061,142140,100079,100079,2087,0,0,0
142170,application_1506638472019_22380,1,26560,26560,142170,115610,115610,2539,0,0,0
142170,application_1508364558011_20612,1,49890,49890,142170,92280,92280,2247,0,0,0
142180,application_1508364558011_45595,1,78356,78356,142180,63824,63824,1658,0,0,0
142180,application_1508364558011_5625,1,40038,40038,142180,102142,102142,1961,0,0,0
142250,application_1508364558011_15293,1,45568,45568,142250,96682,96682,2092,0,0,0
142260,application_1508364558011_35040,1,69882,69882,142260,72378,72378,1429,0,0,0
142320,application_1508364558011_8079,1,41623,41623,142320,100697,100697,2120,0,0,0
142330,application_1506638472019_4906,1,15807,15807,142330,126523,126523,4087,0,0,0
142340,application_1513627406021_1754,1,121297,121297,142340,21043,21043,563,0,0,0
142350,application_1513627406021_2374,1,122364,122364,142350,19986,19986,700,0,0,0
142360,application_1508364558011_7119,1,41277,41277,142360,101083,101083,2448,0,0,0
142430,application_1511916184019_0055,8,96533,96533,142430,45897,45897,904,0,0,0
142440,application_1506638472019_28838,1,29291,29291,142440,113149,113149,2432,0,0,0
142450,application_1508364558011_27471,1,60583,60583,142450,81867,81867,1835,0,0,0
142480,application_1506638472019_8754,1,17534,17534,142480,124946,124946,3521,0,0,0
142510,application_1508364558011_16633,1,46687,46687,142510,95823,95823,2320,0,0,0
142530,application_1506638472019_16426,1,23142,23142,142530,119388,119388,2915,0,0,0
142600,application_1506638472019_19938,1,25013,25013,142600,117587,117587,3789,0,0,0
142650,application_1508364558011_3712,1,39258,39258,142650,103392,103392,1976,0,0,0
142720,application_1513627406021_2386,1,122364,122364,142720,20356,20356,610,0,0,0
142790,application_1508364558011_48971,1,85028,85028,142790,57762,57762,1250,0,0,0
142880,application_1512440382012_2076,1,108631,108631,142880,34249,34249,857,0,0,0
142950,application_1513627406021_2370,1,122363,122363,142950,20587,20587,729,0,0,0
142950,application_1506638472019_5655,1,15901,15901,142950,127049,127049,4028,0,0,0
142960,application_1508364558011_8024,1,41622,41622,142960,101338,101338,2261,0,0,0
142990,application_1512440382012_1149,1,106947,106947,142990,36043,36043,2220,0,0,0
143040,application_1513627406021_0336,1,118283,118283,143040,24757,24757,732,0,0,0
143050,application_1508364558011_34684,1,69783,69783,143050,73267,73267,2206,0,0,0
143060,application_1508364558011_45545,1,78348,78348,143060,64712,64712,1764,0,0,0
143070,application_1508364558011_34679,1,69783,69783,143070,73287,73287,1637,0,0,0
143070,application_1506638472019_27601,1,28775,28775,143070,114295,114295,3608,0,0,0
143090,application_1506638472019_25645,1,27861,27861,143090,115229,115229,2719,0,0,0
143150,application_1508364558011_10377,1,42149,42149,143150,101001,101001,2120,0,0,0
143170,application_1508364558011_34616,1,69782,69782,143170,73388,73388,1571,0,0,0
143310,application_1508364558011_29597,1,66099,66099,143310,77211,77211,1560,0,0,0
143310,application_1513025660013_0218,2,115276,115276,143310,28034,28034,1191,0,0,0
143320,application_1506638472019_24868,1,27758,27758,143320,115562,115562,2576,0,0,0
143330,application_1512440382012_3231,1,109653,109653,143330,33677,33677,1048,0,0,0
143340,application_1508364558011_32395,1,68626,68626,143340,74714,74714,1709,0,0,0
143440,application_1508364558011_4676,1,39803,39803,143440,103637,103637,2673,0,0,0
143480,application_1506638472019_24345,1,27401,27401,143480,116079,116079,2734,0,0,0
143520,application_1508364558011_34504,1,69780,69780,143520,73740,73740,2400,0,0,0
143520,application_1513627406021_1924,1,121467,121467,143520,22053,22053,674,0,0,0
143730,application_1513627406021_0337,1,118283,118283,143730,25447,25447,703,0,0,0
143730,application_1508364558011_30675,1,67115,67115,143730,76615,76615,1880,0,0,0
143740,application_1513627406021_2257,1,122221,122221,143740,21519,21519,685,0,0,0
143820,application_1508364558011_7136,1,41278,41278,143820,102542,102542,2290,0,0,0
143890,application_1506638472019_5105,1,15816,15816,143890,128074,128074,4062,0,0,0
143900,application_1508364558011_32331,1,68615,68615,143900,75285,75285,1552,0,0,0
143950,application_1508364558011_42794,1,76705,76705,143950,67245,67245,2014,0,0,0
143980,application_1508364558011_34541,1,69781,69781,143980,74199,74199,1956,0,0,0
144010,application_1506638472019_5622,1,15900,15900,144010,128110,128110,3717,0,0,0
144060,application_1508364558011_40113,1,73800,73800,144060,70260,70260,1512,0,0,0
144190,application_1508364558011_5605,1,40037,40037,144190,104153,104153,2346,0,0,0
144240,application_1512440382012_5313,1,110552,110552,144240,33688,33688,1206,0,0,0
144250,application_1508364558011_34513,1,69780,69780,144250,74470,74470,1648,0,0,0
144310,application_1508364558011_34634,1,69783,69783,144310,74527,74527,1544,0,0,0
144320,application_1508364558011_30100,1,66340,66340,144320,77980,77980,2030,0,0,0
144380,application_1513627406021_2200,1,122213,122213,144380,22167,22167,672,0,0,0
144390,application_1506638472019_23514,1,27203,27203,144390,117187,117187,2749,0,0,0
144490,application_1508364558011_34785,1,69785,69785,144490,74705,74705,1748,0,0,0
144490,application_1508364558011_6549,1,40811,40811,144490,103679,103679,2286,0,0,0
144490,application_1508364558011_38103,1,73553,73553,144490,70937,70937,1547,0,0,0
144530,application_1506638472019_4974,1,15811,15811,144530,128719,128719,3948,0,0,0
144590,application_1513627406021_2238,1,122219,122219,144590,22371,22371,679,0,0,0
144700,application_1508364558011_20646,1,49916,49916,144700,94784,94784,2204,0,0,0
144710,application_1506638472019_25189,1,27798,27798,144710,116912,116912,3091,0,0,0
144710,application_1508364558011_5048,1,39860,39860,144710,104850,104850,2577,0,0,0
144810,application_1506638472019_23291,1,27176,27176,144810,117634,117634,2738,0,0,0
144920,application_1508364558011_35055,1,69883,69883,144920,75037,75037,1745,0,0,0
145000,application_1506638472019_5131,1,15817,15817,145000,129183,129183,4036,0,0,0
145040,application_1508364558011_31812,1,68259,68259,145040,76781,76781,1618,0,0,0
145040,application_1508364558011_4990,1,39859,39859,145040,105181,105181,2081,0,0,0
145050,application_1506638472019_24156,1,27350,27350,145050,117700,117700,2581,0,0,0
145070,application_1508364558011_21387,1,50725,50725,145070,94345,94345,1992,0,0,0
145100,application_1506638472019_31561,1,31612,31612,145100,113488,113488,4134,0,0,0
145100,application_1508364558011_8885,1,41849,41849,145100,103251,103251,2276,0,0,0
145150,application_1508364558011_33641,1,69532,69532,145150,75618,75618,1703,0,0,0
145190,application_1512440382012_5315,1,110552,110552,145190,34638,34638,1060,0,0,0
145230,application_1508364558011_52003,1,87973,87973,145230,57257,57257,1316,0,0,0
145270,application_1506638472019_5091,1,15815,15815,145270,129455,129455,4104,0,0,0
145340,application_1512440382012_5306,1,110549,110549,145340,34791,34791,1032,0,0,0
145520,application_1508364558011_32370,1,68621,68621,145520,76899,76899,1722,0,0,0
145520,application_1506638472019_5539,1,15897,15897,145520,129623,129623,4069,0,0,0
145590,application_1508364558011_32576,1,68751,68751,145590,76839,76839,1865,0,0,0
145620,application_1506638472019_35053,1,34778,34778,145620,110842,110842,2851,0,0,0
145720,application_1506638472019_25133,1,27790,27790,145720,117930,117930,3347,0,0,0
145730,application_1506638472019_8339,1,17390,17390,145730,128340,128340,3947,0,0,0
145770,application_1508364558011_41048,1,74688,74688,145770,71082,71082,1462,0,0,0
145770,application_1508364558011_33954,1,69712,69712,145770,76058,76058,1717,0,0,0
145790,application_1508364558011_8124,1,41624,41624,145790,104166,104166,2328,0,0,0
145800,application_1506638472019_5290,1,15822,15822,145800,129978,129978,3965,0,0,0
145820,application_1506638472019_31513,1,31604,31604,145820,114216,114216,4082,0,0,0
145820,application_1506638472019_4882,1,15805,15805,145820,130015,130015,4131,0,0,0
145900,application_1506638472019_5162,1,15818,15818,145900,130082,130082,4024,0,0,0
145910,application_1506638472019_5064,1,15814,15814,145910,130096,130096,4006,0,0,0
145940,application_1508364558011_8928,1,41849,41849,145940,104091,104091,2378,0,0,0
145950,application_1508364558011_7202,1,41279,41279,145950,104671,104671,2483,0,0,0
145960,application_1506638472019_4829,1,15800,15800,145960,130160,130160,4361,0,0,0
146000,application_1506638472019_18431,1,24595,24595,146000,121405,121405,3547,0,0,0
146030,application_1508364558011_4603,1,39799,39799,146030,106231,106231,2201,0,0,0
146070,application_1508364558011_8413,1,41641,41641,146070,104429,104429,2122,0,0,0
146150,application_1506638472019_21955,1,26357,26357,146150,119793,119793,2629,0,0,0
146200,application_1513627406021_2214,1,122215,122215,146200,23985,23985,769,0,0,0
146210,application_1508364558011_3601,1,39251,39251,146210,106959,106959,2641,0,0,0
146240,application_1513627406021_2425,1,122368,122368,146240,23872,23872,703,0,0,0
146250,application_1511916184019_1598,1,99682,99682,146250,46568,46568,1006,0,0,0
146350,application_1508364558011_42795,1,76705,76705,146350,69645,69645,1584,0,0,0
146380,application_1506638472019_18084,1,24531,24531,146380,121849,121849,3635,0,0,0
146400,application_1506638472019_4996,1,15812,15812,146400,130588,130588,4737,0,0,0
146460,application_1508364558011_32230,1,68559,68559,146460,77901,77901,1796,0,0,0
146490,application_1508364558011_20629,1,49892,49892,146490,96598,96598,2249,0,0,0
146560,application_1506638472019_5056,1,15814,15814,146560,130746,130746,4107,0,0,0
146610,application_1508364558011_36107,1,70344,70344,146610,76266,76266,1924,0,0,0
146630,application_1508364558011_20610,1,49890,49890,146630,96740,96740,2266,0,0,0
146670,application_1508364558011_32848,1,69121,69121,146670,77549,77549,1717,0,0,0
146690,application_1508364558011_20702,1,50006,50006,146690,96684,96684,2053,0,0,0
146700,application_1508364558011_42733,1,76697,76697,146700,70003,70003,1552,0,0,0
146700,application_1506638472019_5732,1,15904,15904,146700,130796,130796,3904,0,0,0
146720,application_1508364558011_14719,1,45309,45309,146720,101411,101411,2289,0,0,0
146830,application_1506638472019_23585,1,27244,27244,146830,119586,119586,2560,0,0,0
146920,application_1506638472019_16221,1,23100,23100,146920,123820,123820,3095,0,0,0
146930,application_1513627406021_1001,1,119758,119758,146930,27172,27172,659,0,0,0
147110,application_1506638472019_7663,1,17242,17242,147110,129868,129868,3807,0,0,0
147220,application_1513627406021_2247,1,122221,122221,147220,24999,24999,634,0,0,0
147240,application_1513627406021_2249,1,122221,122221,147240,25019,25019,699,0,0,0
147260,application_1506638472019_5055,1,15814,15814,147260,131446,131446,4071,0,0,0
147290,application_1508364558011_32486,1,68647,68647,147290,78643,78643,1605,0,0,0
147300,application_1506638472019_27024,1,28695,28695,147300,118605,118605,3430,0,0,0
147410,application_1508364558011_42728,1,76696,76696,147410,70714,70714,1930,0,0,0
147440,application_1508364558011_34598,1,69782,69782,147440,77658,77658,1712,0,0,0
147500,application_1506638472019_17848,1,24496,24496,147500,123004,123004,3316,0,0,0
147530,application_1506638472019_28670,1,29207,29207,147530,118323,118323,4069,0,0,0
147550,application_1506638472019_18505,1,24602,24602,147550,122948,122948,3474,0,0,0
147580,application_1508364558011_45547,1,78349,78349,147580,69231,69231,1531,0,0,0
147580,application_1511916184019_1752,1,99787,99787,147580,47793,47793,1044,0,0,0
147580,application_1506638472019_24516,1,27696,27696,147580,119884,119884,2734,0,0,0
147640,application_1506638472019_30953,1,31041,31041,147640,116599,116599,3144,0,0,0
147700,application_1506638472019_4925,1,15808,15808,147700,131892,131892,4092,0,0,0
147700,application_1506638472019_5102,1,15816,15816,147700,131884,131884,4060,0,0,0
147730,application_1506638472019_28510,1,29182,29182,147730,118548,118548,2426,0,0,0
147750,application_1506638472019_5668,1,15901,15901,147750,131849,131849,4015,0,0,0
147800,application_1506638472019_5373,1,15892,15892,147800,131908,131908,3986,0,0,0
147810,application_1506638472019_25176,1,27796,27796,147810,120014,120014,3429,0,0,0
147900,application_1513627406021_2217,1,122216,122216,147900,25684,25684,804,0,0,0
147910,application_1508364558011_46337,1,79268,79268,147910,68642,68642,1783,0,0,0
147940,application_1508364558011_7442,1,41282,41282,147940,106658,106658,2394,0,0,0
147940,application_1506638472019_28396,1,29153,29153,147940,118787,118787,2520,0,0,0
147960,application_1513627406021_2652,1,122700,122700,147960,25260,25260,782,0,0,0
147990,application_1508364558011_50093,1,86635,86635,147990,61355,61355,1571,0,0,0
148050,application_1508364558011_37100,1,72101,72101,148050,75949,75949,2227,0,0,0
148070,application_1506638472019_30028,1,30918,30918,148070,117152,117152,3379,0,0,0
148080,application_1513627406021_2353,1,122363,122363,148080,25717,25717,679,0,0,0
148130,application_1508364558011_7171,1,41278,41278,148130,106852,106852,2383,0,0,0
148160,application_1513627406021_2390,1,122364,122364,148160,25796,25796,681,0,0,0
148220,application_1508364558011_9801,1,42138,42138,148220,106082,106082,2858,0,0,0
148230,application_1506638472019_8743,1,17532,17532,148230,130698,130698,3926,0,0,0
148280,application_1508364558011_29180,1,65349,65349,148280,82931,82931,1959,0,0,0
148350,application_1506638472019_17016,1,23332,23332,148350,125018,125018,2934,0,0,0
148360,application_1506638472019_26592,1,28555,28555,148360,119805,119805,3385,0,0,0
148400,application_1508364558011_16620,1,46687,46687,148400,101713,101713,2349,0,0,0
148430,application_1506638472019_20046,1,25136,25136,148430,123294,123294,2842,0,0,0
148450,application_1512440382012_1415,1,107585,107585,148450,40865,40865,1032,0,0,0
148450,application_1508364558011_4182,1,39361,39361,148450,109089,109089,2447,0,0,0
148460,application_1508364558011_42700,1,76694,76694,148460,71766,71766,1762,0,0,0
148470,application_1506638472019_25165,1,27794,27794,148470,120676,120676,5027,0,0,0
148530,application_1508364558011_20645,1,49916,49916,148530,98614,98614,2227,0,0,0
148590,application_1508364558011_32562,1,68749,68749,148590,79841,79841,1962,0,0,0
148670,application_1508364558011_47726,1,81187,81187,148670,67483,67483,1760,0,0,0
148710,application_1508364558011_32408,1,68632,68632,148710,80078,80078,1961,0,0,0
148760,application_1506638472019_5205,1,15819,15819,148760,132941,132941,4026,0,0,0
148860,application_1508364558011_8512,1,41643,41643,148860,107217,107217,2537,0,0,0
148870,application_1508364558011_45542,1,78348,78348,148870,70522,70522,1894,0,0,0
148870,application_1513627406021_2664,1,122700,122700,148870,26170,26170,778,0,0,0
148910,application_1508364558011_8393,1,41641,41641,148910,107269,107269,2340,0,0,0
148920,application_1506638472019_27071,1,28700,28700,148920,120220,120220,3555,0,0,0
148940,application_1513627406021_0334,1,118283,118283,148940,30657,30657,1058,0,0,0
148950,application_1508364558011_31918,1,68406,68406,148950,80544,80544,1930,0,0,0
149080,application_1506638472019_17836,1,24494,24494,149080,124586,124586,3312,0,0,0
149110,application_1512440382012_5297,1,110548,110548,149110,38562,38562,1058,0,0,0
149140,application_1506638472019_7373,1,17210,17210,149140,131930,131930,4448,0,0,0
149150,application_1513627406021_0292,1,118283,118283,149150,30867,30867,1008,0,0,0
149170,application_1508364558011_9735,1,42137,42137,149170,107033,107033,2476,0,0,0
149220,application_1506638472019_24999,1,27772,27772,149220,121448,121448,3247,0,0,0
149310,application_1508364558011_49970,1,86437,86437,149310,62873,62873,1644,0,0,0
149320,application_1508364558011_34714,1,69784,69784,149320,79536,79536,1750,0,0,0
149350,application_1513627406021_1802,1,121333,121333,149350,28017,28017,845,0,0,0
149410,application_1508364558011_14372,1,45001,45001,149410,104409,104409,2286,0,0,0
149460,application_1506638472019_26643,1,28560,28560,149460,120900,120900,3339,0,0,0
149470,application_1512440382012_5458,1,110784,110784,149470,38686,38686,1104,0,0,0
149520,application_1508364558011_21374,1,50724,50724,149520,98796,98796,2437,0,0,0
149550,application_1506638472019_27387,1,28740,28740,149550,120810,120810,3427,0,0,0
149650,application_1506638472019_39066,1,37057,37057,149650,112593,112593,2606,0,0,0
149740,application_1506638472019_19547,1,24919,24919,149740,124821,124821,3241,0,0,0
149760,application_1506638472019_23389,1,27188,27188,149760,122572,122572,4504,0,0,0
149840,application_1506638472019_27303,1,28728,28728,149840,121112,121112,3506,0,0,0
149890,application_1508364558011_15053,1,45565,45565,149890,104325,104325,2229,0,0,0
149960,application_1506638472019_24588,1,27709,27709,149960,122251,122251,5033,0,0,0
149990,application_1506638472019_5682,1,15902,15902,149990,134088,134088,4003,0,0,0
150000,application_1506638472019_30351,1,30955,30955,150000,119045,119045,3165,0,0,0
150010,application_1508364558011_34030,1,69721,69721,150010,80289,80289,1881,0,0,0
150070,application_1506638472019_9135,1,17587,17587,150070,132483,132483,3815,0,0,0
150100,application_1508364558011_26548,1,58991,58991,150100,91109,91109,2783,0,0,0
150140,application_1506638472019_27081,1,28701,28701,150140,121439,121439,3361,0,0,0
150150,application_1506638472019_5388,1,15892,15892,150150,134258,134258,3996,0,0,0
150160,application_1506638472019_27000,1,28658,28658,150160,121502,121502,3468,0,0,0
150260,application_1506638472019_8337,1,17390,17390,150260,132870,132870,3726,0,0,0
150330,application_1508364558011_21508,1,50729,50729,150330,99601,99601,2080,0,0,0
150340,application_1508364558011_33956,1,69712,69712,150340,80628,80628,1813,0,0,0
150370,application_1506638472019_18402,1,24592,24592,150370,125778,125778,3566,0,0,0
150440,application_1506638472019_21609,1,26309,26309,150440,124131,124131,3194,0,0,0
150460,application_1508364558011_42736,1,76697,76697,150460,73763,73763,1726,0,0,0
150530,application_1513627406021_0280,1,118282,118282,150530,32248,32248,1067,0,0,0
150530,application_1506638472019_5707,1,15903,15903,150530,134627,134627,4134,0,0,0
150660,application_1508364558011_4978,1,39859,39859,150660,110801,110801,3238,0,0,0
150750,application_1506638472019_31591,1,31617,31617,150750,119133,119133,4288,0,0,0
150790,application_1508364558011_14860,4,45376,45376,150790,105414,105414,1202,0,0,0
150800,application_1511916184019_2104,1,100727,100727,150800,50073,50073,1463,0,0,0
150800,application_1506638472019_35023,8,34746,34746,150800,116054,116054,984,0,0,0
150870,application_1506638472019_5186,1,15818,15818,150870,135052,135052,4129,0,0,0
150910,application_1506638472019_16816,1,23296,23296,150910,127614,127614,3024,0,0,0
150960,application_1506638472019_19312,1,24867,24867,150960,126093,126093,3833,0,0,0
150970,application_1512440382012_5326,1,110557,110557,150970,40413,40413,1063,0,0,0
151120,application_1513627406021_2212,1,122215,122215,151120,28905,28905,804,0,0,0
151220,application_1506638472019_27235,1,28722,28722,151220,122498,122498,3380,0,0,0
151260,application_1508364558011_36543,1,70856,70856,151260,80404,80404,1737,0,0,0
151260,application_1508364558011_33248,1,69301,69301,151260,81959,81959,1844,0,0,0
151260,application_1508364558011_28828,4,64872,64872,151260,86388,86388,1177,0,0,0
151340,application_1513627406021_2632,1,122700,122700,151340,28640,28640,1013,0,0,0
151400,application_1512440382012_5292,1,110547,110547,151400,40853,40853,1249,0,0,0
151430,application_1506638472019_4857,1,15804,15804,151430,135626,135626,4286,0,0,0
151520,application_1513627406021_2604,1,122700,122700,151520,28820,28820,786,0,0,0
151710,application_1508364558011_34557,1,69782,69782,151710,81928,81928,2272,0,0,0
151820,application_1506638472019_5725,1,15903,15903,151820,135917,135917,4024,0,0,0
151930,application_1513627406021_2219,1,122216,122216,151930,29714,29714,777,0,0,0
151940,application_1506638472019_28162,1,29095,29095,151940,122845,122845,3635,0,0,0
151950,application_1506638472019_29706,1,30127,30127,151950,121823,121823,3335,0,0,0
152000,application_1506638472019_25034,1,27776,27776,152000,124224,124224,3349,0,0,0
152060,application_1508364558011_35118,1,69883,69883,152060,82177,82177,1670,0,0,0
152100,application_1506638472019_5641,1,15900,15900,152100,136200,136200,4120,0,0,0
152130,application_1508364558011_34045,1,69722,69722,152130,82408,82408,2416,0,0,0
152160,application_1506638472019_16994,1,23327,23327,152160,128833,128833,3154,0,0,0
152230,application_1511528684064_2251,1,96188,96188,152230,56042,56042,1399,0,0,0
152300,application_1506638472019_8304,1,17385,17385,152300,134915,134915,3949,0,0,0
152310,application_1506638472019_24573,1,27706,27706,152310,124604,124604,5032,0,0,0
152430,application_1506638472019_4913,1,15807,15807,152430,136623,136623,4040,0,0,0
152470,application_1506638472019_27467,1,28748,28748,152470,123722,123722,3503,0,0,0
152480,application_1506638472019_5204,1,15819,15819,152480,136661,136661,3944,0,0,0
152520,application_1506638472019_27368,1,28736,28736,152520,123784,123784,3627,0,0,0
152580,application_1508364558011_20643,1,49916,49916,152580,102664,102664,2164,0,0,0
152690,application_1508364558011_42925,1,76864,76864,152690,75826,75826,1635,0,0,0
152750,application_1506638472019_7362,1,17209,17209,152750,135541,135541,4380,0,0,0
152750,application_1506638472019_18122,1,24535,24535,152750,128215,128215,3653,0,0,0
152760,application_1508364558011_48865,1,84906,84906,152760,67854,67854,1786,0,0,0
152940,application_1508364558011_34689,1,69783,69783,152940,83157,83157,2117,0,0,0
152940,application_1506638472019_30512,1,30971,30971,152940,121969,121969,3386,0,0,0
152960,application_1513627406021_2438,1,122369,122369,152960,30591,30591,797,0,0,0
153080,application_1506638472019_21619,1,26309,26309,153080,126771,126771,3261,0,0,0
153120,application_1512440382012_5269,1,110544,110544,153120,42576,42576,1155,0,0,0
153140,application_1508364558011_34600,1,69782,69782,153140,83358,83358,2390,0,0,0
153300,application_1506638472019_24443,1,27669,27669,153300,125631,125631,4170,0,0,0
153330,application_1506638472019_27524,1,28758,28758,153330,124572,124572,3366,0,0,0
153390,application_1506638472019_29216,1,29812,29812,153390,123578,123578,3819,0,0,0
153490,application_1513627406021_0298,1,118283,118283,153490,35207,35207,1038,0,0,0
153610,application_1506638472019_5190,1,15819,15819,153610,137791,137791,4080,0,0,0
153640,application_1508364558011_35074,1,69883,69883,153640,83757,83757,1777,0,0,0
153660,application_1508364558011_42722,1,76696,76696,153660,76964,76964,1772,0,0,0
153710,application_1512440382012_1939,1,108371,108371,153710,45339,45339,1434,0,0,0
153750,application_1506638472019_28526,1,29185,29185,153750,124565,124565,3971,0,0,0
153760,application_1508364558011_9372,1,42063,42063,153760,111697,111697,2517,0,0,0
153810,application_1506638472019_27124,1,28708,28708,153810,125102,125102,3658,0,0,0
153920,application_1506638472019_5711,1,15903,15903,153920,138017,138017,4123,0,0,0
154060,application_1506638472019_26623,1,28558,28558,154060,125502,125502,3337,0,0,0
154210,application_1506638472019_5610,1,15899,15899,154210,138311,138311,4769,0,0,0
154220,application_1506638472019_4878,1,15805,15805,154220,138415,138415,4250,0,0,0
154380,application_1508364558011_42514,1,76534,76534,154380,77846,77846,2185,0,0,0
154390,application_1506638472019_19517,1,24914,24914,154390,129476,129476,3826,0,0,0
154410,application_1506638472019_5259,1,15821,15821,154410,138589,138589,4399,0,0,0
154420,application_1506638472019_30815,1,31027,31027,154420,123393,123393,3412,0,0,0
154440,application_1508364558011_31707,1,68082,68082,154440,86358,86358,2092,0,0,0
154440,application_1506638472019_4877,1,15805,15805,154440,138635,138635,4253,0,0,0
154440,application_1506638472019_5551,1,15897,15897,154440,138543,138543,4070,0,0,0
154450,application_1506638472019_27577,1,28770,28770,154450,125680,125680,3395,0,0,0
154470,application_1513627406021_2667,1,122700,122700,154470,31770,31770,1068,0,0,0
154470,application_1508364558011_4105,1,39359,39359,154470,115111,115111,2564,0,0,0
154720,application_1506638472019_5313,1,15823,15823,154720,138897,138897,4159,0,0,0
154780,application_1508364558011_40939,1,74543,74543,154780,80237,80237,1748,0,0,0
154850,application_1508364558011_2178,1,38997,38997,154850,115853,115853,2839,0,0,0
154900,application_1508364558011_49364,1,85504,85504,154900,69396,69396,1447,0,0,0
154920,application_1506638472019_17833,1,24494,24494,154920,130426,130426,3420,0,0,0
154950,application_1512440382012_1892,1,108365,108365,154950,46585,46585,1434,0,0,0
154990,application_1506638472019_26564,1,28552,28552,154990,126438,126438,3376,0,0,0
155010,application_1506638472019_7649,1,17240,17240,155010,137770,137770,4015,0,0,0
155120,application_1508364558011_45597,1,78356,78356,155120,76764,76764,1866,0,0,0
155250,application_1506638472019_27427,1,28744,28744,155250,126506,126506,3337,0,0,0
155270,application_1506638472019_8342,1,17390,17390,155270,137880,137880,4030,0,0,0
155320,application_1513627406021_1774,1,121318,121318,155320,34002,34002,1035,0,0,0
155400,application_1508364558011_8482,1,41642,41642,155400,113758,113758,2670,0,0,0
155410,application_1513627406021_2608,1,122700,122700,155410,32710,32710,878,0,0,0
155420,application_1508364558011_30672,1,67113,67113,155420,88307,88307,1895,0,0,0
155540,application_1506638472019_8998,1,17568,17568,155540,137972,137972,3827,0,0,0
155770,application_1506638472019_27448,1,28746,28746,155770,127024,127024,3354,0,0,0
155840,application_1508364558011_32311,1,68610,68610,155840,87230,87230,1927,0,0,0
155880,application_1506638472019_5789,1,15907,15907,155880,139973,139973,4030,0,0,0
155910,application_1506638472019_25166,1,27795,27795,155910,128115,128115,3279,0,0,0
155910,application_1508364558011_0910,1,37989,37989,155910,117921,117921,4003,0,0,0
155920,application_1506638472019_26611,1,28556,28556,155920,127364,127364,3527,0,0,0
155990,application_1506638472019_19836,1,24991,24991,155990,130999,130999,3997,0,0,0
156210,application_1506638472019_8752,1,17533,17533,156210,138677,138677,3754,0,0,0
156210,application_1511916184019_2008,1,100484,100484,156210,55726,55726,1715,0,0,0
156230,application_1508364558011_45625,1,78360,78360,156230,77870,77870,1819,0,0,0
156280,application_1506638472019_26931,1,28649,28649,156280,127631,127631,3372,0,0,0
156310,application_1511528684064_0771,1,93922,93922,156310,62388,62388,1613,0,0,0
156320,application_1508364558011_30633,1,67108,67108,156320,89212,89212,1907,0,0,0
156380,application_1506638472019_27354,1,28735,28735,156380,127645,127645,3494,0,0,0
156520,application_1506638472019_28227,1,29110,29110,156520,127410,127410,4066,0,0,0
156540,application_1513627406021_2634,1,122700,122700,156540,33840,33840,1018,0,0,0
156550,application_1513025660013_0438,1,115605,115605,156550,40945,40945,1018,0,0,0
156580,application_1506638472019_27474,1,28749,28749,156580,127831,127831,3381,0,0,0
156610,application_1508364558011_11405,8,43198,43198,156610,113412,113412,1401,0,0,0
156820,application_1506638472019_26779,1,28575,28575,156820,128245,128245,3383,0,0,0
156930,application_1506638472019_18384,1,24590,24590,156930,132340,132340,3590,0,0,0
157120,application_1508364558011_4585,1,39799,39799,157120,117321,117321,2855,0,0,0
157130,application_1506638472019_26656,1,28561,28561,157130,128569,128569,3405,0,0,0
157200,application_1506638472019_27070,1,28700,28700,157200,128500,128500,3373,0,0,0
157210,application_1508364558011_15022,1,45564,45564,157210,111646,111646,2643,0,0,0
157230,application_1508364558011_34691,1,69783,69783,157230,87447,87447,1784,0,0,0
157330,application_1506638472019_26685,1,28564,28564,157330,128766,128766,3440,0,0,0
157390,application_1506638472019_30019,1,30913,30913,157390,126477,126477,3402,0,0,0
157450,application_1506638472019_28052,1,29078,29078,157450,128372,128372,3532,0,0,0
157480,application_1506638472019_24975,1,27770,27770,157480,129710,129710,3334,0,0,0
157570,application_1506638472019_18851,1,24779,24779,157570,132791,132791,3951,0,0,0
157580,application_1506638472019_27375,1,28738,28738,157580,128842,128842,3438,0,0,0
157580,application_1506638472019_27108,1,28706,28706,157580,128874,128874,3560,0,0,0
157650,application_1508364558011_34607,1,69782,69782,157650,87868,87868,2369,0,0,0
157650,application_1508364558011_9781,1,42137,42137,157650,115513,115513,2632,0,0,0
157870,application_1506638472019_19210,1,24848,24848,157870,133022,133022,4084,0,0,0
157870,application_1506638472019_5524,1,15897,15897,157870,141973,141973,4636,0,0,0
157970,application_1508364558011_34004,1,69720,69720,157970,88250,88250,2523,0,0,0
157980,application_1506638472019_26696,1,28565,28565,157980,129415,129415,3609,0,0,0
158050,application_1512440382012_6714,4,114895,114895,158050,43155,43155,1036,0,0,0
158100,application_1508364558011_32246,1,68565,68565,158100,89535,89535,2036,0,0,0
158170,application_1513627406021_2673,1,122700,122700,158170,35470,35470,1077,0,0,0
158250,application_1508364558011_42169,1,75999,75999,158250,82251,82251,1895,0,0,0
158390,application_1508364558011_21381,1,50725,50725,158390,107665,107665,2432,0,0,0
158400,application_1512440382012_1965,1,108373,108373,158400,50027,50027,1435,0,0,0
158520,application_1506638472019_27704,1,28922,28922,158520,129598,129598,3641,0,0,0
158570,application_1508364558011_45581,1,78355,78355,158570,80215,80215,1883,0,0,0
158580,application_1508364558011_32317,1,68612,68612,158580,89968,89968,2236,0,0,0
158610,application_1506638472019_34207,1,34510,34510,158610,124100,124100,3794,0,0,0
158620,application_1511528684064_0593,1,93164,93164,158620,65456,65456,1810,0,0,0
158690,application_1506638472019_26941,1,28651,28651,158690,130039,130039,3561,0,0,0
158720,application_1506638472019_26945,1,28651,28651,158720,130069,130069,3354,0,0,0
158740,application_1506638472019_5632,1,15900,15900,158740,142840,142840,4754,0,0,0
158800,application_1506638472019_27596,1,28774,28774,158800,130026,130026,3370,0,0,0
158850,application_1511916184019_1729,1,99771,99771,158850,59079,59079,1860,0,0,0
158900,application_1506638472019_25160,1,27794,27794,158900,131106,131106,3272,0,0,0
159040,application_1506638472019_6696,1,17120,17120,159040,141920,141920,3949,0,0,0
159050,application_1506638472019_6136,4,16697,16697,159050,142353,142353,2751,0,0,0
159070,application_1512440382012_3108,1,109627,109627,159070,49443,49443,1582,0,0,0
159110,application_1508364558011_30623,1,67108,67108,159110,92002,92002,1848,0,0,0
159110,application_1508364558011_45586,1,78356,78356,159110,80754,80754,1897,0,0,0
159180,application_1508364558011_5629,1,40038,40038,159180,119142,119142,2767,0,0,0
159210,application_1512440382012_3090,1,109625,109625,159210,49585,49585,1556,0,0,0
159300,application_1506638472019_27510,1,28754,28754,159300,130546,130546,3391,0,0,0
159410,application_1508364558011_50071,1,86600,86600,159410,72810,72810,1624,0,0,0
159470,application_1506638472019_19561,1,24920,24920,159470,134550,134550,3541,0,0,0
159500,application_1512440382012_3082,1,109622,109622,159500,49878,49878,1533,0,0,0
159510,application_1506638472019_26607,1,28556,28556,159510,130954,130954,3536,0,0,0
159520,application_1508364558011_20697,1,50005,50005,159520,109515,109515,2596,0,0,0
159540,application_1513627406021_2670,1,122700,122700,159540,36840,36840,1097,0,0,0
159550,application_1508364558011_2185,1,38997,38997,159550,120553,120553,2867,0,0,0
159620,application_1506638472019_25046,1,27778,27778,159620,131842,131842,3260,0,0,0
159680,application_1508364558011_30643,1,67110,67110,159680,92570,92570,2411,0,0,0
159690,application_1506638472019_1742,4,10389,10389,159690,149301,149301,5453,0,0,0
159820,application_1512440382012_1955,1,108371,108371,159820,51449,51449,1471,0,0,0
159860,application_1508364558011_38449,1,73565,73565,159860,86295,86295,2035,0,0,0
159900,application_1506638472019_4159,1,14419,14419,159900,145481,145481,5534,0,0,0
159920,application_1506638472019_19002,1,24807,24807,159920,135113,135113,4113,0,0,0
159950,application_1506638472019_26700,1,28566,28566,159950,131384,131384,3628,0,0,0
159960,application_1506638472019_7681,1,17245,17245,159960,142715,142715,3951,0,0,0
159980,application_1506638472019_27330,1,28732,28732,159980,131248,131248,3498,0,0,0
160000,application_1512440382012_3916,1,109838,109838,160000,50162,50162,2530,0,0,0
160040,application_1506638472019_26726,1,28569,28569,160040,131471,131471,3367,0,0,0
160090,application_1508364558011_5035,1,39860,39860,160090,120230,120230,2940,0,0,0
160110,application_1506638472019_27711,1,28923,28923,160110,131187,131187,3486,0,0,0
160180,application_1508364558011_13554,1,44661,44661,160180,115519,115519,2712,0,0,0
160200,application_1511916184019_0776,8,98111,98111,160200,62089,62089,1365,0,0,0
160250,application_1506638472019_27595,1,28774,28774,160250,131476,131476,3457,0,0,0
160270,application_1511528684064_0291,1,91458,91458,160270,68812,68812,1768,0,0,0
160380,application_1512440382012_3088,1,109624,109624,160380,50756,50756,1561,0,0,0
160390,application_1508364558011_32058,1,68425,68425,160390,91965,91965,2040,0,0,0
160390,application_1506638472019_18115,1,24535,24535,160390,135855,135855,3563,0,0,0
160430,application_1508364558011_30213,1,66467,66467,160430,93963,93963,2456,0,0,0
160510,application_1506638472019_26542,1,28550,28550,160510,131960,131960,3472,0,0,0
160540,application_1513627406021_0265,1,118282,118282,160540,42258,42258,1201,0,0,0
160670,application_1506638472019_27194,1,28717,28717,160670,131953,131953,3311,0,0,0
160700,application_1508364558011_30780,1,67123,67123,160700,93577,93577,2323,0,0,0
160790,application_1511916184019_0193,1,96785,96785,160790,64005,64005,1794,0,0,0
160870,application_1506638472019_4991,1,15812,15812,160870,145058,145058,4721,0,0,0
160980,application_1506638472019_5491,1,15896,15896,160980,145084,145084,4232,0,0,0
161170,application_1506638472019_25183,1,27797,27797,161170,133373,133373,3361,0,0,0
161210,application_1508364558011_7215,1,41279,41279,161210,119931,119931,2620,0,0,0
161220,application_1508364558011_7988,1,41601,41601,161220,119619,119619,4530,0,0,0
161230,application_1508364558011_48864,1,84906,84906,161230,76324,76324,2121,0,0,0
161300,application_1506638472019_28651,1,29205,29205,161300,132095,132095,4005,0,0,0
161310,application_1508364558011_45630,1,78361,78361,161310,82949,82949,1868,0,0,0
161340,application_1508364558011_34757,1,69784,69784,161340,91556,91556,2028,0,0,0
161350,application_1506638472019_25142,1,27790,27790,161350,133560,133560,3363,0,0,0
161620,application_1506638472019_27255,1,28723,28723,161620,132897,132897,3534,0,0,0
161890,application_1508364558011_36240,1,70473,70473,161890,91417,91417,1969,0,0,0
161900,application_1508364558011_14387,1,45014,45014,161900,116886,116886,2991,0,0,0
161920,application_1506638472019_14731,2,21630,21630,161920,140290,140290,9785,0,0,0
161960,application_1506638472019_27224,1,28721,28721,161960,133239,133239,3351,0,0,0
161990,application_1512440382012_3184,1,109645,109645,161990,52345,52345,1501,0,0,0
162020,application_1508364558011_9796,1,42138,42138,162020,119882,119882,2766,0,0,0
162170,application_1512440382012_1834,1,108310,108310,162170,53860,53860,1641,0,0,0
162300,application_1508364558011_34451,1,69778,69778,162300,92522,92522,2421,0,0,0
162480,application_1506638472019_28702,1,29212,29212,162480,133268,133268,4050,0,0,0
162550,application_1513025660013_1026,1,116753,116753,162550,45797,45797,1428,0,0,0
162560,application_1512440382012_3174,1,109642,109642,162560,52918,52918,1496,0,0,0
162730,application_1506638472019_5479,1,15895,15895,162730,146835,146835,4634,0,0,0
162820,application_1506638472019_7224,1,17165,17165,162820,145655,145655,4425,0,0,0
162910,application_1506638472019_4951,1,15809,15809,162910,147101,147101,4751,0,0,0
162920,application_1506638472019_28842,1,29292,29292,162920,133628,133628,3669,0,0,0
162950,application_1508364558011_19377,1,48800,48800,162950,114150,114150,2699,0,0,0
163070,application_1506638472019_7198,1,17164,17164,163070,145906,145906,4353,0,0,0
163080,application_1508364558011_6264,1,40582,40582,163080,122498,122498,4378,0,0,0
163140,application_1508364558011_35048,1,69882,69882,163140,93258,93258,2279,0,0,0
163180,application_1506638472019_27181,1,28715,28715,163180,134465,134465,3531,0,0,0
163210,application_1506638472019_9728,1,17669,17669,163210,145541,145541,3817,0,0,0
163210,application_1508364558011_45702,1,78539,78539,163210,84671,84671,3161,0,0,0
163280,application_1512440382012_1898,1,108365,108365,163280,54915,54915,1504,0,0,0
163280,application_1506638472019_31586,1,31616,31616,163280,131664,131664,4011,0,0,0
163500,application_1506638472019_8253,1,17310,17310,163500,146190,146190,4042,0,0,0
163500,application_1506638472019_17738,1,24472,24472,163500,139028,139028,3601,0,0,0
163690,application_1513025660013_0193,1,115247,115247,163690,48443,48443,1619,0,0,0
163710,application_1508364558011_33259,1,69322,69322,163710,94388,94388,2567,0,0,0
163770,application_1506638472019_27353,1,28735,28735,163770,135035,135035,3446,0,0,0
163900,application_1511916184019_2566,8,102055,102055,163900,61845,61845,1028,0,0,0
164180,application_1512440382012_2682,1,109435,109435,164180,54745,54745,1475,0,0,0
164250,application_1506638472019_38173,1,36239,36239,164250,128011,128011,3232,0,0,0
164270,application_1506638472019_28689,1,29210,29210,164270,135060,135060,4027,0,0,0
164300,application_1511528684064_0595,1,93164,93164,164300,71136,71136,1889,0,0,0
164420,application_1512440382012_3145,1,109634,109634,164420,54786,54786,1516,0,0,0
164520,application_1512440382012_1966,1,108373,108373,164520,56147,56147,1643,0,0,0
164550,application_1511916184019_2106,1,100728,100728,164550,63822,63822,1987,0,0,0
164670,application_1506638472019_8266,1,17339,17339,164670,147331,147331,4431,0,0,0
164770,application_1506638472019_7411,1,17214,17214,164770,147556,147556,4362,0,0,0
164800,application_1508364558011_45591,1,78356,78356,164800,86444,86444,2250,0,0,0
164970,application_1506638472019_26850,1,28588,28588,164970,136382,136382,3513,0,0,0
165020,application_1506638472019_27116,1,28706,28706,165020,136314,136314,3520,0,0,0
165040,application_1512440382012_5385,1,110636,110636,165040,54404,54404,1626,0,0,0
165100,application_1506638472019_25022,1,27775,27775,165100,137325,137325,3708,0,0,0
165150,application_1508364558011_32490,1,68649,68649,165150,96501,96501,2501,0,0,0
165200,application_1508364558011_29387,1,65930,65930,165200,99270,99270,2353,0,0,0
165220,application_1511528684064_0900,1,94227,94227,165220,70993,70993,2555,0,0,0
165230,application_1506638472019_25103,1,27785,27785,165230,137445,137445,3476,0,0,0
165320,application_1506638472019_30026,1,30918,30918,165320,134402,134402,3386,0,0,0
165470,application_1508364558011_32833,1,69105,69105,165470,96365,96365,3092,0,0,0
165570,application_1506638472019_18856,1,24780,24780,165570,140790,140790,3896,0,0,0
165790,application_1512440382012_1897,1,108365,108365,165790,57425,57425,1392,0,0,0
165820,application_1506638472019_27317,1,28730,28730,165820,137090,137090,3343,0,0,0
165830,application_1508364558011_27381,1,60341,60341,165830,105489,105489,2836,0,0,0
165880,application_1506638472019_18849,1,24779,24779,165880,141101,141101,3851,0,0,0
165900,application_1506638472019_25897,1,27957,27957,165900,137943,137943,5020,0,0,0
165910,application_1506638472019_27976,1,29070,29070,165910,136840,136840,3994,0,0,0
166080,application_1508364558011_0911,1,37989,37989,166080,128091,128091,3955,0,0,0
166180,application_1506638472019_28158,1,29094,29094,166180,137086,137086,3683,0,0,0
166250,application_1508364558011_29441,1,65992,65992,166250,100258,100258,2952,0,0,0
166510,application_1508364558011_34569,1,69782,69782,166510,96728,96728,2107,0,0,0
166540,application_1512440382012_0120,1,105290,105290,166540,61250,61250,1840,0,0,0
166580,application_1506638472019_25833,1,27942,27942,166580,138638,138638,5183,0,0,0
166640,application_1512440382012_3083,1,109623,109623,166640,57017,57017,1558,0,0,0
166650,application_1508364558011_34511,1,69780,69780,166650,96870,96870,2413,0,0,0
166780,application_1506638472019_27720,1,28924,28924,166780,137856,137856,3596,0,0,0
166790,application_1506638472019_28144,1,29089,29089,166790,137701,137701,3641,0,0,0
166860,application_1508364558011_35891,1,70163,70163,166860,96697,96697,3223,0,0,0
166950,application_1508364558011_34029,1,69721,69721,166950,97229,97229,2339,0,0,0
166980,application_1508364558011_34665,1,69783,69783,166980,97197,97197,2418,0,0,0
167060,application_1512440382012_1878,1,108364,108364,167060,58696,58696,1645,0,0,0
167090,application_1512440382012_3112,1,109628,109628,167090,57462,57462,1572,0,0,0
167210,application_1508364558011_31890,1,68383,68383,167210,98827,98827,2158,0,0,0
167240,application_1508364558011_20716,1,50006,50006,167240,117234,117234,3100,0,0,0
167270,application_1504131676014_24496,8,6831,6831,167270,160439,160439,9096,0,0,0
167320,application_1506638472019_30765,1,31022,31022,167320,136298,136298,3385,0,0,0
167360,application_1513025660013_0576,1,115804,115804,167360,51556,51556,1562,0,0,0
167370,application_1506638472019_8642,1,17431,17431,167370,149939,149939,4393,0,0,0
167410,application_1506638472019_28708,1,29213,29213,167410,138197,138197,3947,0,0,0
167510,application_1512440382012_5370,1,110635,110635,167510,56875,56875,1748,0,0,0
167550,application_1513025660013_0677,1,116072,116072,167550,51478,51478,1426,0,0,0
167610,application_1512440382012_1917,1,108366,108366,167610,59244,59244,1530,0,0,0
167660,application_1512440382012_6637,4,114776,114776,167660,52884,52884,998,0,0,0
167790,application_1506638472019_5306,1,15822,15822,167790,151968,151968,4173,0,0,0
167810,application_1506638472019_26517,1,28546,28546,167810,139264,139264,3460,0,0,0
167920,application_1506638472019_25945,1,27996,27996,167920,139924,139924,5243,0,0,0
167950,application_1513025660013_0201,1,115261,115261,167950,52689,52689,1524,0,0,0
168280,application_1506638472019_26844,1,28587,28587,168280,139693,139693,3593,0,0,0
168360,application_1512440382012_4318,1,109914,109914,168360,58446,58446,2539,0,0,0
168590,application_1508364558011_32333,1,68615,68615,168590,99975,99975,3289,0,0,0
168710,application_1506638472019_27632,1,28784,28784,168710,139926,139926,3473,0,0,0
168790,application_1506638472019_18844,1,24778,24778,168790,144012,144012,4008,0,0,0
168820,application_1506638472019_24294,1,27388,27388,168820,141432,141432,4138,0,0,0
169020,application_1508364558011_35133,1,69883,69883,169020,99137,99137,2388,0,0,0
169120,application_1506638472019_23279,1,27175,27175,169120,141945,141945,4184,0,0,0
169240,application_1512440382012_5325,1,110557,110557,169240,58683,58683,1651,0,0,0
169290,application_1508364558011_35165,1,69884,69884,169290,99406,99406,2558,0,0,0
169720,application_1506638472019_2561,1,13162,13162,169720,156558,156558,5912,0,0,0
169950,application_1512440382012_5268,1,110544,110544,169950,59406,59406,1873,0,0,0
169990,application_1506638472019_19440,1,24897,24897,169990,145093,145093,3956,0,0,0
170150,application_1506638472019_28343,1,29145,29145,170150,141005,141005,3397,0,0,0
170210,application_1508364558011_20466,1,49643,49643,170210,120567,120567,3132,0,0,0
170250,application_1508364558011_36084,1,70339,70339,170250,99911,99911,2627,0,0,0
170280,application_1506638472019_26566,1,28552,28552,170280,141728,141728,3488,0,0,0
170290,application_1506638472019_26984,1,28658,28658,170290,141632,141632,3556,0,0,0
170320,application_1508364558011_36075,1,70339,70339,170320,99981,99981,2919,0,0,0
170420,application_1512440382012_6715,1,114896,114896,170420,55524,55524,1714,0,0,0
170590,application_1506638472019_26929,1,28649,28649,170590,141941,141941,3354,0,0,0
170620,application_1506638472019_29026,1,29348,29348,170620,141272,141272,3960,0,0,0
170680,application_1513627406021_0310,1,118283,118283,170680,52397,52397,1640,0,0,0
170730,application_1508364558011_36101,1,70342,70342,170730,100388,100388,2553,0,0,0
170730,application_1508364558011_0632,4,37769,37769,170730,132961,132961,2632,0,0,0
170790,application_1511916184019_0058,8,96541,96541,170790,74249,74249,1560,0,0,0
171110,application_1512440382012_4496,1,109943,109943,171110,61167,61167,2622,0,0,0
171130,application_1506638472019_22966,1,27010,27010,171130,144120,144120,3856,0,0,0
171280,application_1508364558011_30420,4,66903,66903,171280,104377,104377,2197,0,0,0
171430,application_1506638472019_18846,1,24779,24779,171430,146651,146651,4004,0,0,0
171460,application_1506638472019_27491,1,28751,28751,171460,142709,142709,3724,0,0,0
171530,application_1506638472019_24191,1,27364,27364,171530,144166,144166,4501,0,0,0
171600,application_1508364558011_42876,1,76803,76803,171600,94797,94797,2332,0,0,0
171610,application_1512440382012_3091,1,109625,109625,171610,61985,61985,1632,0,0,0
171660,application_1508364558011_7852,1,41588,41588,171660,130072,130072,6573,0,0,0
171930,application_1513025660013_0604,1,115897,115897,171930,56033,56033,1709,0,0,0
171970,application_1506638472019_34203,1,34509,34509,171970,137461,137461,4905,0,0,0
172010,application_1513627406021_0487,1,118523,118523,172010,53487,53487,1582,0,0,0
172030,application_1506638472019_28948,1,29314,29314,172030,142716,142716,4010,0,0,0
172100,application_1506638472019_27492,1,28751,28751,172100,143349,143349,3575,0,0,0
172280,application_1512440382012_3157,1,109637,109637,172280,62643,62643,1672,0,0,0
172290,application_1506638472019_28715,1,29215,29215,172290,143075,143075,3658,0,0,0
172360,application_1506638472019_27629,1,28782,28782,172360,143578,143578,3563,0,0,0
172370,application_1506638472019_20116,1,25176,25176,172370,147194,147194,3951,0,0,0
172370,application_1508364558011_11703,8,43346,43346,172370,129024,129024,2094,0,0,0
172540,application_1508364558011_37309,1,72292,72292,172540,100248,100248,2632,0,0,0
172570,application_1511916184019_3000,4,103851,103851,172570,68719,68719,2163,0,0,0
172660,application_1506638472019_27552,1,28765,28765,172660,143895,143895,3641,0,0,0
172700,application_1508364558011_16974,4,47139,47139,172700,125561,125561,1694,0,0,0
173000,application_1506638472019_31213,1,31208,31208,173000,141792,141792,4039,0,0,0
173080,application_1506638472019_29203,1,29808,29808,173080,143272,143272,4034,0,0,0
173100,application_1508364558011_13378,1,44457,44457,173100,128643,128643,3393,0,0,0
173120,application_1511916184019_2990,1,103826,103826,173120,69294,69294,2124,0,0,0
173230,application_1512440382012_1950,1,108371,108371,173230,64859,64859,1788,0,0,0
173360,application_1512440382012_1855,1,108331,108331,173360,65029,65029,2237,0,0,0
173380,application_1508364558011_1387,1,38547,38547,173380,134833,134833,3565,0,0,0
173410,application_1512440382012_5456,1,110784,110784,173410,62626,62626,1718,0,0,0
173480,application_1506638472019_36018,1,35067,35067,173480,138413,138413,6005,0,0,0
173490,application_1508364558011_35155,1,69884,69884,173490,103606,103606,2602,0,0,0
173520,application_1506638472019_35045,1,34778,34778,173520,138742,138742,3180,0,0,0
173600,application_1508364558011_7886,1,41589,41589,173600,132011,132011,3982,0,0,0
173630,application_1506638472019_31546,1,31609,31609,173630,142021,142021,4533,0,0,0
173660,application_1506638472019_31514,1,31604,31604,173660,142056,142056,4539,0,0,0
173810,application_1508364558011_36533,1,70850,70850,173810,102960,102960,2460,0,0,0
173840,application_1506638472019_23414,1,27191,27191,173840,146649,146649,4304,0,0,0
173910,application_1506638472019_25664,1,27864,27864,173910,146046,146046,4133,0,0,0
173940,application_1511916184019_1389,1,99473,99473,173940,74467,74467,2315,0,0,0
173970,application_1506638472019_28562,1,29192,29192,173970,144778,144778,3928,0,0,0
174270,application_1513627406021_0239,1,118269,118269,174270,56001,56001,1714,0,0,0
175220,application_1506638472019_25779,1,27930,27930,175220,147290,147290,4989,0,0,0
175250,application_1508364558011_35934,1,70166,70166,175250,105084,105084,3939,0,0,0
175620,application_1508364558011_26219,1,58606,58606,175620,117014,117014,2822,0,0,0
175710,application_1506638472019_25877,1,27953,27953,175710,147757,147757,5146,0,0,0
176130,application_1508364558011_7887,1,41589,41589,176130,134541,134541,4044,0,0,0
176270,application_1506638472019_28550,1,29190,29190,176270,147080,147080,3985,0,0,0
176280,application_1506638472019_26897,1,28643,28643,176280,147637,147637,3631,0,0,0
176310,application_1506638472019_28029,1,29076,29076,176310,147234,147234,4000,0,0,0
176580,application_1508364558011_35926,1,70166,70166,176580,106414,106414,2654,0,0,0
176610,application_1508364558011_36059,1,70337,70337,176610,106273,106273,2585,0,0,0
176680,application_1506638472019_24478,1,27681,27681,176680,148999,148999,4517,0,0,0
176910,application_1508364558011_16819,1,46810,46810,176910,130100,130100,3784,0,0,0
176930,application_1512440382012_4445,1,109935,109935,176930,66995,66995,2494,0,0,0
177050,application_1508364558011_7839,1,41587,41587,177050,135463,135463,4201,0,0,0
177110,application_1508364558011_25799,4,57871,57871,177110,119239,119239,3472,0,0,0
177250,application_1512440382012_6499,2,114336,114336,177250,62914,62914,3366,0,0,0
177620,application_1508364558011_7823,1,41587,41587,177620,136033,136033,4008,0,0,0
177720,application_1506638472019_28586,1,29196,29196,177720,148524,148524,4011,0,0,0
177740,application_1512440382012_3504,1,109690,109690,177740,68050,68050,2613,0,0,0
177830,application_1506638472019_28528,1,29185,29185,177830,148645,148645,4080,0,0,0
178180,application_1506638472019_26014,1,28020,28020,178180,150160,150160,5129,0,0,0
178240,application_1506638472019_28169,1,29098,29098,178240,149142,149142,4075,0,0,0
178500,application_1506638472019_26072,1,28034,28034,178500,150466,150466,5170,0,0,0
178520,application_1511916184019_0705,1,98022,98022,178520,80498,80498,2716,0,0,0
178610,application_1513627406021_0186,1,118201,118201,178610,60409,60409,1928,0,0,0
178900,application_1506638472019_19986,1,25064,25064,178900,153836,153836,4140,0,0,0
179010,application_1511528684064_1629,4,95912,95912,179010,83098,83098,2167,0,0,0
179050,application_1506638472019_31563,1,31612,31612,179050,147438,147438,4145,0,0,0
179130,application_1508364558011_35914,1,70165,70165,179130,108965,108965,2972,0,0,0
179260,application_1511916184019_0485,1,97619,97619,179260,81641,81641,2229,0,0,0
179270,application_1506638472019_23242,1,27171,27171,179270,152099,152099,4547,0,0,0
179430,application_1508364558011_6275,1,40582,40582,179430,138848,138848,3880,0,0,0
179580,application_1506638472019_35080,1,34779,34779,179580,144801,144801,4068,0,0,0
179660,application_1506638472019_5906,4,16096,16096,179660,163564,163564,4241,0,0,0
179690,application_1506638472019_28971,1,29317,29317,179690,150373,150373,4039,0,0,0
179740,application_1508364558011_47624,1,80906,80906,179740,98834,98834,2779,0,0,0
179840,application_1506638472019_28797,1,29229,29229,179840,150611,150611,3961,0,0,0
179950,application_1508364558011_40619,1,74026,74026,179950,105924,105924,3044,0,0,0
180210,application_1506638472019_19444,1,24898,24898,180210,155312,155312,4974,0,0,0
180230,application_1506638472019_28762,1,29222,29222,180230,151008,151008,4015,0,0,0
180310,application_1508364558011_17481,1,47489,47489,180310,132821,132821,3651,0,0,0
180460,application_1512440382012_2491,1,109106,109106,180460,71354,71354,2086,0,0,0
180550,application_1506638472019_26108,1,28044,28044,180550,152506,152506,5207,0,0,0
180670,application_1508364558011_51949,1,87910,87910,180670,92760,92760,2530,0,0,0
180770,application_1512440382012_3611,1,109713,109713,180770,71057,71057,2490,0,0,0
180930,application_1513025660013_0113,1,115113,115113,180930,65817,65817,2190,0,0,0
181200,application_1512440382012_3591,1,109711,109711,181200,71489,71489,2498,0,0,0
181240,application_1506638472019_5305,1,15822,15822,181240,165418,165418,5666,0,0,0
181460,application_1506638472019_1134,4,9588,9588,181460,171872,171872,5581,0,0,0
181640,application_1508364558011_49033,1,85088,85088,181640,96552,96552,2830,0,0,0
181960,application_1512440382012_3553,1,109701,109701,181960,72259,72259,2509,0,0,0
182140,application_1506638472019_24581,1,27707,27707,182140,154433,154433,5005,0,0,0
182160,application_1508364558011_42993,1,76978,76978,182160,105182,105182,2780,0,0,0
182220,application_1512440382012_3317,1,109665,109665,182220,72555,72555,2588,0,0,0
182280,application_1506638472019_19145,1,24836,24836,182280,157444,157444,4117,0,0,0
182500,application_1512440382012_4417,1,109931,109931,182500,72569,72569,2473,0,0,0
182730,application_1506638472019_29205,1,29808,29808,182730,152922,152922,4029,0,0,0
182760,application_1512440382012_4022,1,109858,109858,182760,72902,72902,2568,0,0,0
182770,application_1508364558011_33535,1,69513,69513,182770,113257,113257,3295,0,0,0
182820,application_1506638472019_24335,1,27400,27400,182820,155420,155420,4524,0,0,0
183010,application_1511528684064_1841,1,96072,96072,183010,86938,86938,5438,0,0,0
183010,application_1511528684064_0918,1,94240,94240,183010,88770,88770,2612,0,0,0
183090,application_1506638472019_25273,1,27813,27813,183090,155277,155277,5327,0,0,0
183190,application_1506638472019_24651,1,27722,27722,183190,155468,155468,4868,0,0,0
183310,application_1506638472019_28387,1,29152,29152,183310,154158,154158,4013,0,0,0
183340,application_1508364558011_4471,1,39417,39417,183340,143923,143923,3431,0,0,0
183410,application_1508364558011_35198,1,69943,69943,183410,113467,113467,2863,0,0,0
183420,application_1508364558011_35931,1,70166,70166,183420,113254,113254,2769,0,0,0
183500,application_1506638472019_31574,1,31614,31614,183500,151886,151886,4184,0,0,0
183590,application_1508364558011_36826,1,71398,71398,183590,112192,112192,3041,0,0,0
183890,application_1508364558011_29405,1,65942,65942,183890,117948,117948,2873,0,0,0
184060,application_1506638472019_25640,1,27860,27860,184060,156200,156200,4461,0,0,0
184230,application_1512440382012_0204,1,105462,105462,184230,78768,78768,2691,0,0,0
184270,application_1506638472019_25071,1,27780,27780,184270,156490,156490,5154,0,0,0
184350,application_1512440382012_3303,1,109664,109664,184350,74686,74686,2570,0,0,0
184400,application_1508364558011_35893,1,70163,70163,184400,114237,114237,3305,0,0,0
184450,application_1508364558011_0894,1,37988,37988,184450,146462,146462,3898,0,0,0
184480,application_1506638472019_23631,1,27250,27250,184480,157230,157230,4106,0,0,0
184710,application_1512440382012_4059,1,109864,109864,184710,74846,74846,2494,0,0,0
185060,application_1506638472019_10352,1,18318,18318,185060,166742,166742,4793,0,0,0
185100,application_1506638472019_5991,4,16252,16252,185100,168848,168848,4447,0,0,0
185130,application_1512440382012_3158,1,109637,109637,185130,75493,75493,2122,0,0,0
185160,application_1506638472019_23669,1,27256,27256,185160,157904,157904,4540,0,0,0
185200,application_1512440382012_4346,1,109918,109918,185200,75282,75282,2673,0,0,0
185210,application_1512440382012_3676,1,109728,109728,185210,75482,75482,2532,0,0,0
185210,application_1512440382012_1975,1,108377,108377,185210,76833,76833,2257,0,0,0
185340,application_1506638472019_26109,1,28044,28044,185340,157296,157296,5477,0,0,0
185390,application_1512440382012_4922,1,110077,110077,185390,75313,75313,2424,0,0,0
185400,application_1506638472019_25332,1,27823,27823,185400,157577,157577,5100,0,0,0
185550,application_1512440382012_4896,1,110072,110072,185550,75478,75478,2514,0,0,0
185640,application_1512440382012_3674,1,109727,109727,185640,75913,75913,2537,0,0,0
185650,application_1512440382012_4482,1,109941,109941,185650,75709,75709,2566,0,0,0
185660,application_1512440382012_3985,1,109852,109852,185660,75808,75808,2574,0,0,0
185690,application_1508364558011_6301,1,40584,40584,185690,145106,145106,3987,0,0,0
185820,application_1512440382012_4525,1,109951,109951,185820,75869,75869,2591,0,0,0
185840,application_1508364558011_0753,1,37806,37806,185840,148034,148034,3939,0,0,0
185870,application_1512440382012_3131,1,109631,109631,185870,76239,76239,3018,0,0,0
186140,application_1506638472019_35061,1,34778,34778,186140,151362,151362,4041,0,0,0
186190,application_1508364558011_41034,1,74662,74662,186190,111528,111528,3109,0,0,0
186190,application_1508364558011_0675,1,37802,37802,186190,148388,148388,3925,0,0,0
186280,application_1512440382012_3736,1,109787,109787,186280,76493,76493,2519,0,0,0
186370,application_1508364558011_35503,1,70067,70067,186370,116303,116303,2808,0,0,0
186400,application_1506638472019_24285,1,27384,27384,186400,159016,159016,4626,0,0,0
186460,application_1508364558011_35918,1,70165,70165,186460,116295,116295,3023,0,0,0
186530,application_1508364558011_0674,1,37802,37802,186530,148728,148728,4154,0,0,0
186630,application_1512440382012_4900,1,110072,110072,186630,76558,76558,2541,0,0,0
186630,application_1506638472019_5590,1,15899,15899,186630,170731,170731,5354,0,0,0
186640,application_1512440382012_4016,1,109857,109857,186640,76783,76783,2578,0,0,0
186740,application_1506638472019_31526,1,31606,31606,186740,155134,155134,4345,0,0,0
186910,application_1512440382012_3548,1,109700,109700,186910,77210,77210,2549,0,0,0
186930,application_1506638472019_26081,1,28037,28037,186930,158893,158893,5021,0,0,0
187460,application_1511528684064_0926,1,94244,94244,187460,93216,93216,2638,0,0,0
187700,application_1506638472019_28658,1,29206,29206,187700,158494,158494,3989,0,0,0
187720,application_1508364558011_51921,1,87860,87860,187720,99860,99860,2766,0,0,0
188020,application_1511528684064_0922,1,94242,94242,188020,93778,93778,2639,0,0,0
188080,application_1511528684064_0931,1,94246,94246,188080,93834,93834,2642,0,0,0
188170,application_1512440382012_4069,1,109867,109867,188170,78303,78303,2636,0,0,0
188200,application_1506638472019_24548,1,27702,27702,188200,160498,160498,4990,0,0,0
188200,application_1506638472019_24194,1,27365,27365,188200,160835,160835,4541,0,0,0
188660,application_1508364558011_48549,1,84577,84577,188660,104083,104083,3240,0,0,0
188670,application_1506638472019_24496,1,27694,27694,188670,160976,160976,4573,0,0,0
188790,application_1512440382012_3612,1,109713,109713,188790,79077,79077,2652,0,0,0
188920,application_1508364558011_0901,1,37988,37988,188920,150932,150932,4146,0,0,0
188930,application_1508364558011_12895,1,43749,43749,188930,145181,145181,4393,0,0,0
188940,application_1513627406021_0299,1,118283,118283,188940,70657,70657,2490,0,0,0
188990,application_1512440382012_3668,1,109725,109725,188990,79265,79265,2666,0,0,0
188990,application_1508364558011_6366,1,40711,40711,188990,148279,148279,4039,0,0,0
189100,application_1512440382012_3135,1,109631,109631,189100,79469,79469,2210,0,0,0
189170,application_1512440382012_4297,1,109911,109911,189170,79259,79259,2651,0,0,0
189200,application_1512440382012_3644,1,109718,109718,189200,79482,79482,2622,0,0,0
189290,application_1512440382012_3484,1,109685,109685,189290,79605,79605,2688,0,0,0
189290,application_1512440382012_3405,1,109674,109674,189290,79616,79616,2571,0,0,0
189310,application_1512440382012_3451,1,109678,109678,189310,79632,79632,2614,0,0,0
189360,application_1512440382012_3439,1,109677,109677,189360,79683,79683,2628,0,0,0
189520,application_1512440382012_4855,1,110065,110065,189520,79455,79455,2614,0,0,0
189720,application_1512440382012_3658,1,109721,109721,189720,79999,79999,2498,0,0,0
189750,application_1508364558011_29275,2,65629,65629,189750,124121,124121,8798,0,0,0
189800,application_1506638472019_26168,1,28060,28060,189800,161740,161740,5223,0,0,0
189850,application_1508364558011_32804,1,69063,69063,189850,120787,120787,3576,0,0,0
190080,application_1512440382012_1538,1,107852,107852,190080,82228,82228,2638,0,0,0
190080,application_1506638472019_24211,1,27367,27367,190080,162713,162713,4502,0,0,0
190130,application_1512440382012_3618,1,109714,109714,190130,80416,80416,2517,0,0,0
190150,application_1508364558011_48572,1,84582,84582,190150,105568,105568,3171,0,0,0
190170,application_1508364558011_13254,1,44229,44229,190170,145941,145941,4901,0,0,0
190290,application_1512440382012_4328,1,109915,109915,190290,80375,80375,2494,0,0,0
190470,application_1506638472019_31522,1,31605,31605,190470,158865,158865,4366,0,0,0
190470,application_1506638472019_24736,1,27738,27738,190470,162732,162732,5271,0,0,0
190480,application_1508364558011_0748,1,37805,37805,190480,152675,152675,4619,0,0,0
190630,application_1508364558011_12760,1,43650,43650,190630,146980,146980,4071,0,0,0
190890,application_1511916184019_3203,1,104176,104176,190890,86714,86714,2899,0,0,0
190950,application_1506638472019_31605,1,31620,31620,190950,159330,159330,4247,0,0,0
191120,application_1512440382012_3540,1,109698,109698,191120,81422,81422,2761,0,0,0
191180,application_1506638472019_31604,1,31620,31620,191180,159560,159560,4145,0,0,0
191180,application_1508364558011_15410,1,45617,45617,191180,145563,145563,3867,0,0,0
191280,application_1512440382012_4508,1,109946,109946,191280,81334,81334,2670,0,0,0
191370,application_1512440382012_4267,1,109907,109907,191370,81463,81463,2573,0,0,0
191430,application_1512440382012_3664,1,109723,109723,191430,81707,81707,2534,0,0,0
191490,application_1512440382012_3889,1,109833,109833,191490,81657,81657,2584,0,0,0
191670,application_1512440382012_3527,1,109695,109695,191670,81975,81975,2724,0,0,0
191690,application_1512440382012_3679,1,109729,109729,191690,81961,81961,2573,0,0,0
191720,application_1513025660013_0350,1,115463,115463,191720,76257,76257,2998,0,0,0
191760,application_1512440382012_5157,1,110457,110457,191760,81303,81303,2531,0,0,0
191780,application_1512440382012_4386,1,109925,109925,191780,81855,81855,2625,0,0,0
191840,application_1512440382012_4239,1,109902,109902,191840,81938,81938,2652,0,0,0
191890,application_1506638472019_29201,1,29808,29808,191890,162082,162082,4094,0,0,0
191930,application_1508364558011_13226,1,44227,44227,191930,147703,147703,3799,0,0,0
192030,application_1506638472019_31576,1,31615,31615,192030,160415,160415,4645,0,0,0
192200,application_1508364558011_36282,1,70536,70536,192200,121664,121664,3594,0,0,0
192280,application_1512440382012_4253,1,109904,109904,192280,82376,82376,2537,0,0,0
192400,application_1512440382012_4484,1,109941,109941,192400,82459,82459,2488,0,0,0
192490,application_1512440382012_4437,1,109934,109934,192490,82556,82556,2615,0,0,0
192540,application_1512440382012_0142,1,105344,105344,192540,87196,87196,2704,0,0,0
192760,application_1506638472019_24608,1,27713,27713,192760,165047,165047,4976,0,0,0
192780,application_1506638472019_24257,1,27375,27375,192780,165405,165405,4460,0,0,0
192780,application_1506638472019_17158,1,23360,23360,192780,169420,169420,5827,0,0,0
192810,application_1506638472019_25637,1,27860,27860,192810,164950,164950,4531,0,0,0
192840,application_1508364558011_31942,1,68410,68410,192840,124430,124430,3450,0,0,0
192880,application_1512440382012_4062,1,109865,109865,192880,83015,83015,2585,0,0,0
192940,application_1512440382012_3324,1,109666,109666,192940,83274,83274,2611,0,0,0
192960,application_1512440382012_4524,1,109951,109951,192960,83009,83009,2503,0,0,0
192990,application_1506638472019_16122,1,23080,23080,192990,169910,169910,5830,0,0,0
193030,application_1506638472019_26279,1,28322,28322,193030,164708,164708,5699,0,0,0
193420,application_1506638472019_19329,1,24871,24871,193420,168549,168549,5117,0,0,0
193440,application_1506638472019_36186,1,35142,35142,193440,158298,158298,6409,0,0,0
193460,application_1512440382012_3783,1,109816,109816,193460,83644,83644,2582,0,0,0
193650,application_1508364558011_48631,1,84594,84594,193650,109056,109056,3395,0,0,0
193690,application_1512440382012_4400,1,109928,109928,193690,83762,83762,2576,0,0,0
193800,application_1511916184019_2559,8,102046,102046,193800,91754,91754,2335,0,0,0
193820,application_1512440382012_4321,1,109914,109914,193820,83906,83906,2611,0,0,0
194140,application_1506638472019_25883,1,27954,27954,194140,166186,166186,5139,0,0,0
194240,application_1508364558011_48708,1,84692,84692,194240,109548,109548,3131,0,0,0
194250,application_1506638472019_25775,1,27929,27929,194250,166321,166321,5146,0,0,0
194420,application_1506638472019_26113,1,28045,28045,194420,166375,166375,5282,0,0,0
194420,application_1512440382012_4513,1,109948,109948,194420,84472,84472,2618,0,0,0
194430,application_1512440382012_3608,1,109713,109713,194430,84717,84717,2598,0,0,0
194480,application_1506638472019_26181,1,28064,28064,194480,166416,166416,4997,0,0,0
194750,application_1512440382012_3942,1,109845,109845,194750,84905,84905,2615,0,0,0
194750,application_1512440382012_4877,1,110069,110069,194750,84681,84681,2788,0,0,0
194830,application_1506638472019_31606,1,31621,31621,194830,163209,163209,4436,0,0,0
195030,application_1508364558011_48553,1,84578,84578,195030,110452,110452,3128,0,0,0
195270,application_1508364558011_48602,1,84588,84588,195270,110682,110682,3288,0,0,0
195270,application_1508364558011_25860,4,57931,57931,195270,137339,137339,2656,0,0,0
195300,application_1513627406021_0631,1,118877,118877,195300,76423,76423,2652,0,0,0
195540,application_1508364558011_0691,1,37803,37803,195540,157737,157737,4467,0,0,0
195580,application_1512440382012_3620,1,109715,109715,195580,85865,85865,2608,0,0,0
195600,application_1512440382012_4331,1,109915,109915,195600,85685,85685,2681,0,0,0
195620,application_1512440382012_5154,1,110456,110456,195620,85164,85164,2480,0,0,0
195630,application_1506638472019_26188,1,28066,28066,195630,167564,167564,5004,0,0,0
195670,application_1512440382012_3345,1,109668,109668,195670,86002,86002,2547,0,0,0
195680,application_1506638472019_27327,1,28732,28732,195680,166948,166948,5293,0,0,0
195760,application_1506638472019_25915,1,27962,27962,195760,167798,167798,5285,0,0,0
195850,application_1508364558011_35895,1,70163,70163,195850,125687,125687,3991,0,0,0
195850,application_1508364558011_48598,1,84587,84587,195850,111263,111263,3153,0,0,0
195870,application_1506638472019_26058,1,28030,28030,195870,167840,167840,4879,0,0,0
196000,application_1508364558011_43248,1,77489,77489,196000,118511,118511,3744,0,0,0
196150,application_1506638472019_37018,1,35534,35534,196150,160616,160616,4398,0,0,0
196170,application_1506638472019_25321,1,27821,27821,196170,168349,168349,5239,0,0,0
196300,application_1506638472019_24632,1,27718,27718,196300,168582,168582,5148,0,0,0
196350,application_1506638472019_24767,1,27743,27743,196350,168607,168607,4903,0,0,0
196370,application_1506638472019_25112,1,27787,27787,196370,168583,168583,5065,0,0,0
196400,application_1508364558011_16747,1,46807,46807,196400,149593,149593,4227,0,0,0
196420,application_1508364558011_18903,4,48189,48189,196420,148231,148231,2554,0,0,0
196460,application_1512440382012_3520,1,109693,109693,196460,86767,86767,2626,0,0,0
196490,application_1506638472019_19824,1,24989,24989,196490,171501,171501,4864,0,0,0
196520,application_1512440382012_4338,1,109917,109917,196520,86603,86603,2642,0,0,0
196530,application_1506638472019_25418,1,27836,27836,196530,168694,168694,5027,0,0,0
196540,application_1506638472019_24673,1,27726,27726,196540,168814,168814,4926,0,0,0
196610,application_1506638472019_25979,1,28005,28005,196610,168605,168605,4992,0,0,0
196880,application_1508364558011_7854,1,41588,41588,196880,155292,155292,4385,0,0,0
196900,application_1506638472019_23362,1,27185,27185,196900,169715,169715,4525,0,0,0
197140,application_1508364558011_13023,1,43929,43929,197140,153211,153211,4754,0,0,0
197320,application_1508364558011_14653,1,45189,45189,197320,152131,152131,4573,0,0,0
197400,application_1508364558011_0906,1,37989,37989,197400,159411,159411,4041,0,0,0
197510,application_1506638472019_24553,1,27703,27703,197510,169807,169807,4978,0,0,0
197710,application_1506638472019_12571,1,19040,19040,197710,178670,178670,5649,0,0,0
197730,application_1508364558011_48557,1,84580,84580,197730,113150,113150,3269,0,0,0
197900,application_1512440382012_0513,1,105992,105992,197900,91908,91908,3991,0,0,0
197940,application_1512440382012_4843,1,110063,110063,197940,87877,87877,2529,0,0,0
198060,application_1508364558011_16736,1,46807,46807,198060,151253,151253,3997,0,0,0
198080,application_1512440382012_4790,1,110054,110054,198080,88026,88026,4018,0,0,0
198140,application_1506638472019_36408,1,35211,35211,198140,162929,162929,6185,0,0,0
198270,application_1512440382012_3545,1,109699,109699,198270,88571,88571,2579,0,0,0
198640,application_1512440382012_5153,1,110456,110456,198640,88184,88184,2600,0,0,0
198680,application_1506638472019_25344,1,27825,27825,198680,170855,170855,5065,0,0,0
198730,application_1512440382012_4254,1,109904,109904,198730,88826,88826,2645,0,0,0
198760,application_1506638472019_8481,1,17410,17410,198760,181350,181350,5815,0,0,0
199090,application_1512440382012_3561,1,109703,109703,199090,89387,89387,2545,0,0,0
199200,application_1508364558011_14655,1,45189,45189,199200,154011,154011,4671,0,0,0
199250,application_1512440382012_3874,1,109831,109831,199250,89419,89419,2491,0,0,0
199260,application_1506638472019_25197,1,27799,27799,199260,171461,171461,5159,0,0,0
199280,application_1513025660013_0661,1,116024,116024,199280,83256,83256,2597,0,0,0
199310,application_1506638472019_24786,1,27747,27747,199310,171563,171563,5000,0,0,0
199360,application_1512440382012_4432,1,109933,109933,199360,89427,89427,2681,0,0,0
199400,application_1512440382012_4335,1,109916,109916,199400,89484,89484,2532,0,0,0
199920,application_1506638472019_27283,1,28726,28726,199920,171194,171194,5779,0,0,0
199930,application_1506638472019_25974,1,28003,28003,199930,171927,171927,5037,0,0,0
200090,application_1506638472019_25965,1,28001,28001,200090,172089,172089,5149,0,0,0
200130,application_1508364558011_6886,1,40927,40927,200130,159203,159203,4455,0,0,0
200300,application_1508364558011_16789,1,46809,46809,200300,153491,153491,4127,0,0,0
200640,application_1508364558011_52495,1,88462,88462,200640,112178,112178,3279,0,0,0
200910,application_1512440382012_4786,1,110054,110054,200910,90856,90856,2648,0,0,0
200960,application_1508364558011_14681,1,45190,45190,200960,155770,155770,4292,0,0,0
201030,application_1513025660013_0204,8,115262,115262,201030,85768,85768,2381,0,0,0
201280,application_1508364558011_7508,1,41407,41407,201280,159873,159873,4271,0,0,0
201380,application_1512440382012_2030,1,108494,108494,201380,92886,92886,3122,0,0,0
201450,application_1508364558011_23705,1,56074,56074,201450,145376,145376,4700,0,0,0
201450,application_1506638472019_25158,1,27793,27793,201450,173657,173657,5018,0,0,0
201530,application_1511916184019_2985,1,103818,103818,201530,97712,97712,2769,0,0,0
201670,application_1506638472019_25444,1,27839,27839,201670,173831,173831,4922,0,0,0
201680,application_1506638472019_24753,1,27741,27741,201680,173939,173939,4965,0,0,0
201720,application_1506638472019_24730,1,27736,27736,201720,173984,173984,5163,0,0,0
201780,application_1513025660013_0501,4,115666,115666,201780,86114,86114,2583,0,0,0
201800,application_1508364558011_7986,1,41601,41601,201800,160199,160199,4704,0,0,0
201830,application_1508364558011_48633,1,84594,84594,201830,117236,117236,3352,0,0,0
202170,application_1506638472019_25825,1,27940,27940,202170,174230,174230,5180,0,0,0
202240,application_1506638472019_16635,1,23259,23259,202240,178981,178981,5695,0,0,0
202280,application_1508364558011_16857,1,46891,46891,202280,155389,155389,4536,0,0,0
202540,application_1508364558011_6870,1,40927,40927,202540,161613,161613,4194,0,0,0
202620,application_1508364558011_14676,1,45190,45190,202620,157430,157430,4669,0,0,0
202910,application_1508364558011_27993,1,62439,62439,202910,140471,140471,4404,0,0,0
202910,application_1508364558011_13241,1,44228,44228,202910,158682,158682,4674,0,0,0
202970,application_1508364558011_5975,1,40178,40178,202970,162792,162792,4975,0,0,0
203220,application_1506638472019_27338,1,28733,28733,203220,174487,174487,5424,0,0,0
203340,application_1506638472019_25929,1,27966,27966,203340,175374,175374,4964,0,0,0
203370,application_1508364558011_13125,1,44134,44134,203370,159236,159236,5314,0,0,0
203550,application_1506638472019_24654,1,27722,27722,203550,175828,175828,5192,0,0,0
203830,application_1506638472019_24703,1,27732,27732,203830,176098,176098,5067,0,0,0
203900,application_1508364558011_35940,1,70167,70167,203900,133733,133733,3945,0,0,0
203900,application_1506638472019_25759,1,27924,27924,203900,175976,175976,5320,0,0,0
204060,application_1508364558011_50750,1,87254,87254,204060,116806,116806,5840,0,0,0
204110,application_1513627406021_2062,1,121885,121885,204110,82225,82225,2908,0,0,0
204150,application_1506638472019_32259,1,33240,33240,204150,170910,170910,5070,0,0,0
204210,application_1506638472019_24603,1,27712,27712,204210,176498,176498,5070,0,0,0
204220,application_1506638472019_17180,1,23365,23365,204220,180855,180855,5546,0,0,0
204390,application_1506638472019_26210,1,28071,28071,204390,176319,176319,5197,0,0,0
204630,application_1511528684064_2644,1,96325,96325,204630,108305,108305,5661,0,0,0
204820,application_1506638472019_25092,1,27783,27783,204820,177037,177037,5113,0,0,0
204940,application_1506638472019_25797,1,27934,27934,204940,177006,177006,5208,0,0,0
205010,application_1506638472019_25430,1,27837,27837,205010,177173,177173,5073,0,0,0
205350,application_1506638472019_26554,1,28551,28551,205350,176799,176799,5917,0,0,0
205420,application_1506638472019_32242,1,33238,33238,205420,172182,172182,4956,0,0,0
205510,application_1506638472019_25930,1,27966,27966,205510,177544,177544,5368,0,0,0
205540,application_1506638472019_26953,1,28652,28652,205540,176888,176888,5472,0,0,0
205540,application_1506638472019_37032,1,35534,35534,205540,170006,170006,5094,0,0,0
205570,application_1506638472019_32245,1,33239,33239,205570,172331,172331,5107,0,0,0
205570,application_1506638472019_25847,1,27945,27945,205570,177625,177625,5128,0,0,0
205670,application_1506638472019_25968,1,28002,28002,205670,177668,177668,5407,0,0,0
205820,application_1508364558011_51093,1,87293,87293,205820,118527,118527,4548,0,0,0
205830,application_1512440382012_1344,1,107368,107368,205830,98462,98462,3480,0,0,0
205860,application_1506638472019_25363,1,27829,27829,205860,178031,178031,5304,0,0,0
205940,application_1506638472019_17186,1,23366,23366,205940,182574,182574,5695,0,0,0
206050,application_1508364558011_24092,1,56111,56111,206050,149939,149939,4061,0,0,0
206050,application_1506638472019_25812,1,27937,27937,206050,178113,178113,5274,0,0,0
206140,application_1506638472019_37026,1,35534,35534,206140,170606,170606,4379,0,0,0
206180,application_1506638472019_25271,1,27813,27813,206180,178367,178367,5360,0,0,0
206590,application_1508364558011_33527,1,69512,69512,206590,137078,137078,4094,0,0,0
206660,application_1506638472019_25089,1,27783,27783,206660,178877,178877,4942,0,0,0
206670,application_1506638472019_36737,1,35364,35364,206670,171306,171306,5862,0,0,0
206730,application_1506638472019_26041,1,28025,28025,206730,178705,178705,5416,0,0,0
206920,application_1504131676014_24929,8,7438,7438,206920,199482,199482,11792,0,0,0
207040,application_1513627406021_1488,1,120912,120912,207040,86128,86128,2904,0,0,0
207040,application_1508364558011_46218,1,79178,79178,207040,127862,127862,4799,0,0,0
207060,application_1512440382012_3343,1,109668,109668,207060,97392,97392,3640,0,0,0
207250,application_1506638472019_25259,1,27811,27811,207250,179439,179439,5256,0,0,0
207490,application_1511916184019_3314,1,104301,104301,207490,103189,103189,3447,0,0,0
207520,application_1506638472019_26627,1,28558,28558,207520,178962,178962,5262,0,0,0
207530,application_1506638472019_25316,1,27820,27820,207530,179710,179710,5013,0,0,0
207540,application_1506638472019_25512,1,27846,27846,207540,179694,179694,5102,0,0,0
207620,application_1506638472019_25768,1,27927,27927,207620,179693,179693,5330,0,0,0
207750,application_1513627406021_1489,1,120912,120912,207750,86838,86838,2949,0,0,0
207980,application_1506638472019_24739,1,27738,27738,207980,180242,180242,5216,0,0,0
208000,application_1511528684064_1577,1,95840,95840,208000,112160,112160,5383,0,0,0
208240,application_1506638472019_16145,1,23085,23085,208240,185155,185155,5555,0,0,0
208350,application_1512440382012_1076,1,106846,106846,208350,101504,101504,3049,0,0,0
208390,application_1512440382012_4054,1,109863,109863,208390,98527,98527,4512,0,0,0
208440,application_1506638472019_24683,1,27728,27728,208440,180712,180712,5294,0,0,0
208730,application_1506638472019_24587,1,27708,27708,208730,181022,181022,5193,0,0,0
208820,application_1506638472019_24639,1,27720,27720,208820,181100,181100,5343,0,0,0
208920,application_1506638472019_36927,1,35500,35500,208920,173420,173420,5809,0,0,0
209020,application_1506638472019_17137,1,23356,23356,209020,185664,185664,5769,0,0,0
209330,application_1506638472019_16696,1,23273,23273,209330,186057,186057,5549,0,0,0
209390,application_1508364558011_39483,1,73665,73665,209390,135725,135725,3780,0,0,0
209480,application_1508364558011_4027,1,39331,39331,209480,170149,170149,6335,0,0,0
209540,application_1506638472019_35943,1,35053,35053,209540,174487,174487,5907,0,0,0
209570,application_1506638472019_26228,1,28080,28080,209570,181490,181490,4961,0,0,0
209760,application_1512440382012_6381,1,114144,114144,209760,95616,95616,3552,0,0,0
209830,application_1506638472019_24755,1,27741,27741,209830,182089,182089,5061,0,0,0
209920,application_1506638472019_17147,1,23358,23358,209920,186562,186562,5656,0,0,0
210030,application_1506638472019_25185,1,27797,27797,210030,182233,182233,5371,0,0,0
210050,application_1506638472019_25901,1,27959,27959,210050,182091,182091,4948,0,0,0
210190,application_1506638472019_16117,1,23080,23080,210190,187110,187110,5945,0,0,0
210330,application_1508364558011_29524,1,66085,66085,210330,144245,144245,4423,0,0,0
210330,application_1508364558011_28728,1,64738,64738,210330,145592,145592,4206,0,0,0
210360,application_1506638472019_26152,1,28056,28056,210360,182304,182304,5206,0,0,0
210510,application_1513627406021_1005,1,119758,119758,210510,90752,90752,3297,0,0,0
210680,application_1508364558011_32038,1,68420,68420,210680,142260,142260,4259,0,0,0
210720,application_1506638472019_35560,1,34953,34953,210720,175767,175767,5699,0,0,0
211120,application_1506638472019_16115,1,23079,23079,211120,188041,188041,5840,0,0,0
211240,application_1506638472019_25394,1,27832,27832,211240,183408,183408,5279,0,0,0
211340,application_1506638472019_14638,2,21624,21624,211340,189716,189716,14972,0,0,0
211440,application_1506638472019_26162,1,28059,28059,211440,183381,183381,5172,0,0,0
211590,application_1506638472019_4161,1,14420,14420,211590,197170,197170,6640,0,0,0
211760,application_1508364558011_32028,1,68419,68419,211760,143341,143341,4175,0,0,0
211860,application_1506638472019_10583,1,18569,18569,211860,193291,193291,6228,0,0,0
212080,application_1506638472019_16170,1,23089,23089,212080,188991,188991,5703,0,0,0
212190,application_1506638472019_3834,1,14011,14011,212190,198179,198179,7262,0,0,0
212320,application_1506638472019_35959,1,35057,35057,212320,177263,177263,5900,0,0,0
212340,application_1506638472019_31961,1,32656,32656,212340,179684,179684,5221,0,0,0
212350,application_1508364558011_39506,1,73719,73719,212350,138631,138631,5484,0,0,0
212790,application_1506638472019_24959,1,27767,27767,212790,185023,185023,5524,0,0,0
212850,application_1506638472019_26247,1,28257,28257,212850,184593,184593,5137,0,0,0
212890,application_1506638472019_36389,1,35207,35207,212890,177683,177683,5689,0,0,0
212930,application_1506638472019_23164,1,27164,27164,212930,185766,185766,5912,0,0,0
212940,application_1508364558011_32213,1,68543,68543,212940,144397,144397,4188,0,0,0
213070,application_1506638472019_20205,1,25494,25494,213070,187576,187576,5321,0,0,0
213370,application_1512440382012_4510,1,109946,109946,213370,103424,103424,3632,0,0,0
213580,application_1512440382012_4058,1,109864,109864,213580,103716,103716,3939,0,0,0
213730,application_1506638472019_32244,1,33239,33239,213730,180491,180491,4889,0,0,0
213830,application_1506638472019_27249,1,28723,28723,213830,185107,185107,5869,0,0,0
213950,application_1512440382012_4490,1,109942,109942,213950,104008,104008,4742,0,0,0
214190,application_1506638472019_31407,1,31459,31459,214190,182731,182731,5238,0,0,0
214520,application_1512440382012_5145,1,110454,110454,214520,104066,104066,3966,0,0,0
214570,application_1506638472019_32237,1,33238,33238,214570,181332,181332,5160,0,0,0
214620,application_1506638472019_36397,1,35209,35209,214620,179411,179411,5896,0,0,0
214640,application_1508364558011_32002,1,68417,68417,214640,146223,146223,4168,0,0,0
214740,application_1506638472019_24818,1,27753,27753,214740,186987,186987,5149,0,0,0
214860,application_1506638472019_25893,1,27956,27956,214860,186904,186904,5473,0,0,0
214870,application_1508364558011_13036,1,43930,43930,214870,170940,170940,5298,0,0,0
214890,application_1506638472019_14181,1,20122,20122,214890,194768,194768,6281,0,0,0
215510,application_1508364558011_13246,1,44228,44228,215510,171282,171282,4937,0,0,0
215600,application_1506638472019_16126,1,23081,23081,215600,192519,192519,5892,0,0,0
215710,application_1506638472019_27498,1,28752,28752,215710,186958,186958,5896,0,0,0
215930,application_1512440382012_3966,1,109849,109849,215930,106081,106081,3544,0,0,0
216060,application_1512440382012_3446,1,109678,109678,216060,106382,106382,3974,0,0,0
216180,application_1508364558011_14951,1,45537,45537,216180,170643,170643,4680,0,0,0
216510,application_1513627406021_1613,1,121097,121097,216510,95413,95413,3526,0,0,0
216590,application_1508364558011_45799,1,78737,78737,216590,137853,137853,4429,0,0,0
216610,application_1506638472019_27392,1,28740,28740,216610,187870,187870,5435,0,0,0
216730,application_1512440382012_0538,1,106075,106075,216730,110655,110655,3996,0,0,0
216920,application_1512440382012_3661,1,109721,109721,216920,107199,107199,3987,0,0,0
216990,application_1512440382012_5147,1,110455,110455,216990,106535,106535,3827,0,0,0
217060,application_1506638472019_17179,1,23364,23364,217060,193696,193696,5813,0,0,0
217140,application_1512440382012_4802,1,110056,110056,217140,107084,107084,3839,0,0,0
217280,application_1506638472019_27027,1,28695,28695,217280,188585,188585,5892,0,0,0
217470,application_1513627406021_0290,1,118282,118282,217470,99188,99188,3591,0,0,0
217470,application_1506638472019_26737,1,28570,28570,217470,188900,188900,5941,0,0,0
217590,application_1508364558011_48941,1,84987,84987,217590,132603,132603,4518,0,0,0
217650,application_1506638472019_26667,1,28563,28563,217650,189087,189087,5812,0,0,0
218010,application_1506638472019_14184,1,20125,20125,218010,197885,197885,6553,0,0,0
218100,application_1508364558011_13215,1,44215,44215,218100,173885,173885,5010,0,0,0
218190,application_1508364558011_45757,1,78634,78634,218190,139556,139556,4620,0,0,0
218350,application_1512440382012_4337,1,109916,109916,218350,108434,108434,3977,0,0,0
218430,application_1506638472019_27023,1,28694,28694,218430,189736,189736,5902,0,0,0
218510,application_1506638472019_36677,1,35354,35354,218510,183156,183156,6209,0,0,0
218510,application_1512440382012_2311,8,108860,108860,218510,109650,109650,2622,0,0,0
218610,application_1506638472019_23150,1,27163,27163,218610,191447,191447,6184,0,0,0
218660,application_1506638472019_36760,1,35370,35370,218660,183290,183290,6267,0,0,0
218800,application_1506638472019_27237,1,28722,28722,218800,190078,190078,5954,0,0,0
218830,application_1506638472019_27068,1,28700,28700,218830,190130,190130,5843,0,0,0
219040,application_1506638472019_26898,1,28643,28643,219040,190397,190397,5894,0,0,0
219100,application_1506638472019_26105,1,28044,28044,219100,191056,191056,5188,0,0,0
219210,application_1512440382012_4915,1,110075,110075,219210,109135,109135,3626,0,0,0
219240,application_1506638472019_32669,1,33414,33414,219240,185826,185826,5574,0,0,0
219270,application_1512440382012_0170,1,105419,105419,219270,113851,113851,4179,0,0,0
219300,application_1508364558011_6242,1,40581,40581,219300,178719,178719,6057,0,0,0
219410,application_1506638472019_17166,1,23362,23362,219410,196048,196048,5860,0,0,0
219420,application_1512440382012_3861,1,109829,109829,219420,109591,109591,3781,0,0,0
219500,application_1506638472019_33107,1,34066,34066,219500,185434,185434,6050,0,0,0
219560,application_1511528684064_1699,1,96004,96004,219560,123556,123556,5390,0,0,0
219680,application_1512440382012_3556,1,109702,109702,219680,109978,109978,4137,0,0,0
219680,application_1506638472019_27334,1,28732,28732,219680,190948,190948,5875,0,0,0
219780,application_1512440382012_4792,1,110054,110054,219780,109726,109726,3964,0,0,0
219780,application_1508364558011_51266,1,87341,87341,219780,132439,132439,5725,0,0,0
219820,application_1506638472019_36401,1,35210,35210,219820,184610,184610,6015,0,0,0
220080,application_1506638472019_2240,1,11772,11772,220080,208308,208308,8039,0,0,0
220150,application_1511528684064_1802,1,96066,96066,220150,124084,124084,5423,0,0,0
220240,application_1506638472019_25687,1,27881,27881,220240,192359,192359,5708,0,0,0
220370,application_1508364558011_51137,1,87298,87298,220370,133072,133072,5095,0,0,0
220440,application_1513025660013_0818,16,116339,116339,220440,104101,104101,8035,0,0,0
220450,application_1508364558011_20374,12,49628,220160,220450,290,170822,289,170532,0,0
220590,application_1506638472019_36751,1,35367,35367,220590,185223,185223,5916,0,0,0
220890,application_1506638472019_27029,1,28696,28696,220890,192194,192194,5348,0,0,0
221200,application_1511528684064_2314,1,96212,96212,221200,124988,124988,5740,0,0,0
221470,application_1508364558011_45743,1,78610,78610,221470,142860,142860,4331,0,0,0
221530,application_1512440382012_4066,1,109866,109866,221530,111664,111664,4202,0,0,0
221670,application_1506638472019_36570,1,35245,35245,221670,186425,186425,6028,0,0,0
221980,application_1506638472019_35321,1,34916,34916,221980,187064,187064,6013,0,0,0
222060,application_1513627406021_0630,1,118877,118877,222060,103183,103183,3589,0,0,0
222200,application_1506638472019_26529,1,28548,28548,222200,193652,193652,5536,0,0,0
222200,application_1508364558011_31887,1,68381,68381,222200,153819,153819,4297,0,0,0
222480,application_1506638472019_35320,1,34916,34916,222480,187564,187564,6042,0,0,0
222540,application_1506638472019_35975,1,35059,35059,222540,187481,187481,5881,0,0,0
222650,application_1506638472019_26544,1,28550,28550,222650,194100,194100,5566,0,0,0
222710,application_1506638472019_36366,1,35203,35203,222710,187507,187507,5969,0,0,0
222800,application_1506638472019_36559,1,35244,35244,222800,187556,187556,6234,0,0,0
222950,application_1512440382012_3817,1,109821,109821,222950,113129,113129,3992,0,0,0
223050,application_1506638472019_35546,1,34951,34951,223050,188099,188099,5912,0,0,0
223050,application_1506638472019_27565,1,28767,28767,223050,194283,194283,5833,0,0,0
223280,application_1506638472019_26278,1,28322,28322,223280,194958,194958,5667,0,0,0
223310,application_1508364558011_43265,1,77535,77535,223310,145775,145775,4783,0,0,0
223390,application_1506638472019_36515,1,35234,35234,223390,188156,188156,6253,0,0,0
223570,application_1511528684064_2225,1,96184,96184,223570,127386,127386,5370,0,0,0
223610,application_1506638472019_26928,1,28648,28648,223610,194962,194962,5857,0,0,0
223660,application_1512440382012_3859,1,109828,109828,223660,113832,113832,3955,0,0,0
223660,application_1512440382012_4917,1,110076,110076,223660,113584,113584,3980,0,0,0
223700,application_1508364558011_47479,1,80606,80606,223700,143094,143094,4084,0,0,0
223760,application_1506638472019_27217,1,28720,28720,223760,195040,195040,5533,0,0,0
223780,application_1506638472019_36420,1,35214,35214,223780,188566,188566,5988,0,0,0
223840,application_1508364558011_51131,1,87297,87297,223840,136543,136543,4433,0,0,0
224500,application_1512440382012_4384,1,109924,109924,224500,114576,114576,3912,0,0,0
224520,application_1506638472019_34094,4,34417,34417,224520,190103,190103,5290,0,0,0
224620,application_1506638472019_36716,1,35362,35362,224620,189258,189258,6104,0,0,0
224640,application_1512440382012_4827,1,110060,110060,224640,114580,114580,3807,0,0,0
224740,application_1512440382012_4813,1,110058,110058,224740,114682,114682,3994,0,0,0
224810,application_1506638472019_35928,1,35051,35051,224810,189759,189759,5905,0,0,0
224910,application_1506638472019_36779,1,35374,35374,224910,189536,189536,5980,0,0,0
224960,application_1506638472019_36183,1,35142,35142,224960,189818,189818,6121,0,0,0
224960,application_1512440382012_3507,1,109690,109690,224960,115270,115270,3833,0,0,0
225030,application_1512440382012_4260,1,109905,109905,225030,115125,115125,4145,0,0,0
225090,application_1512440382012_4457,1,109936,109936,225090,115154,115154,4027,0,0,0
225170,application_1506638472019_26557,1,28551,28551,225170,196619,196619,5897,0,0,0
225180,application_1506638472019_36210,1,35145,35145,225180,190035,190035,5895,0,0,0
225190,application_1512440382012_3860,1,109829,109829,225190,115361,115361,3953,0,0,0
225470,application_1512440382012_3855,1,109828,109828,225470,115642,115642,3719,0,0,0
225910,application_1512440382012_4870,1,110068,110068,225910,115842,115842,3978,0,0,0
226340,application_1512440382012_3887,1,109833,109833,226340,116507,116507,3913,0,0,0
226440,application_1511528684064_1408,1,95354,95354,226440,131086,131086,4246,0,0,0
226470,application_1508364558011_52163,1,88176,88176,226470,138294,138294,6280,0,0,0
226510,application_1506638472019_27575,1,28769,28769,226510,197741,197741,5953,0,0,0
226530,application_1508364558011_37045,4,72047,72047,226530,154483,154483,4398,0,0,0
226560,application_1512440382012_0864,1,106520,106520,226560,120040,120040,3948,0,0,0
226610,application_1506638472019_27558,1,28766,28766,226610,197844,197844,5870,0,0,0
226650,application_1508364558011_13022,1,43929,43929,226650,182721,182721,7383,0,0,0
226870,application_1506638472019_36946,1,35504,35504,226870,191366,191366,5846,0,0,0
227280,application_1513627406021_2061,1,121885,121885,227280,105395,105395,3775,0,0,0
227300,application_1512440382012_4858,1,110066,110066,227300,117234,117234,3833,0,0,0
227450,application_1506638472019_24675,1,27726,27726,227450,199724,199724,5727,0,0,0
227450,application_1512440382012_3933,1,109842,109842,227450,117608,117608,4203,0,0,0
227650,application_1506638472019_27174,1,28714,28714,227650,198936,198936,5966,0,0,0
227690,application_1508364558011_42242,8,76117,76117,227690,151573,151573,3544,0,0,0
227860,application_1508364558011_51188,1,87304,87304,227860,140556,140556,6005,0,0,0
227950,application_1506638472019_35489,1,34943,34943,227950,193007,193007,5825,0,0,0
227950,application_1506638472019_36803,1,35381,35381,227950,192569,192569,5921,0,0,0
228150,application_1506638472019_36338,1,35198,35198,228150,192952,192952,5823,0,0,0
228200,application_1511528684064_1527,1,95671,95671,228200,132529,132529,4654,0,0,0
228260,application_1508364558011_14942,1,45536,45536,228260,182724,182724,5927,0,0,0
228440,application_1506638472019_36170,1,35140,35140,228440,193300,193300,6053,0,0,0
228470,application_1506638472019_33130,1,34103,34103,228470,194367,194367,6220,0,0,0
228620,application_1506638472019_26793,1,28577,28577,228620,200043,200043,5891,0,0,0
228630,application_1512440382012_4410,1,109930,109930,228630,118700,118700,3911,0,0,0
228670,application_1506638472019_36653,1,35348,35348,228670,193322,193322,6147,0,0,0
228690,application_1508364558011_0927,1,37990,37990,228690,190700,190700,6338,0,0,0
228920,application_1506638472019_35967,1,35058,35058,228920,193862,193862,6131,0,0,0
229110,application_1512440382012_4853,1,110065,110065,229110,119045,119045,3922,0,0,0
229210,application_1506638472019_35929,1,35051,35051,229210,194159,194159,6441,0,0,0
229230,application_1508364558011_17406,1,47461,47461,229230,181769,181769,5579,0,0,0
229310,application_1511528684064_1682,1,96002,96002,229310,133308,133308,6160,0,0,0
229400,application_1506638472019_35589,1,34959,34959,229400,194441,194441,5757,0,0,0
229400,application_1506638472019_36759,1,35369,35369,229400,194031,194031,5990,0,0,0
229460,application_1506638472019_27036,1,28696,28696,229460,200764,200764,5803,0,0,0
229520,application_1506638472019_23136,1,27162,27162,229520,202358,202358,6699,0,0,0
229660,application_1508364558011_31837,1,68282,68282,229660,161378,161378,4623,0,0,0
229680,application_1512440382012_4107,1,109873,109873,229680,119807,119807,3909,0,0,0
229770,application_1506638472019_35361,1,34924,34924,229770,194846,194846,5923,0,0,0
229790,application_1506638472019_35304,1,34910,34910,229790,194880,194880,5845,0,0,0
229900,application_1506638472019_36786,1,35376,35376,229900,194524,194524,6022,0,0,0
229970,application_1506638472019_25675,1,27879,27879,229970,202091,202091,6283,0,0,0
230030,application_1506638472019_35384,1,34927,34927,230030,195103,195103,5769,0,0,0
230320,application_1508364558011_7883,1,41589,41589,230320,188731,188731,6058,0,0,0
230390,application_1508364558011_7976,1,41601,41601,230390,188789,188789,6415,0,0,0
230720,application_1511528684064_2347,1,96217,96217,230720,134503,134503,5557,0,0,0
230900,application_1511916184019_0932,1,98391,98391,230900,132509,132509,4809,0,0,0
231070,application_1506638472019_36924,1,35499,35499,231070,195571,195571,5993,0,0,0
231200,application_1506638472019_36571,1,35246,35246,231200,195954,195954,5991,0,0,0
231910,application_1506638472019_36172,1,35140,35140,231910,196770,196770,6071,0,0,0
232560,application_1506638472019_27039,1,28697,28697,232560,203863,203863,5935,0,0,0
232650,application_1506638472019_36651,1,35348,35348,232650,197302,197302,6103,0,0,0
232650,application_1506638472019_31745,1,31965,31965,232650,200685,200685,6260,0,0,0
232650,application_1506638472019_10324,8,18299,18299,232650,214351,214351,5643,0,0,0
232850,application_1511528684064_1593,1,95842,95842,232850,137008,137008,5440,0,0,0
232970,application_1506638472019_35364,1,34924,34924,232970,198046,198046,5935,0,0,0
232980,application_1506638472019_35316,1,34914,34914,232980,198066,198066,5998,0,0,0
233030,application_1511528684064_2675,1,96330,96330,233030,136700,136700,5258,0,0,0
233070,application_1512440382012_3941,1,109844,109844,233070,123226,123226,4268,0,0,0
233080,application_1506638472019_36467,1,35224,35224,233080,197856,197856,5935,0,0,0
233100,application_1506638472019_36104,1,35127,35127,233100,197973,197973,6104,0,0,0
233150,application_1512440382012_4367,1,109922,109922,233150,123228,123228,4314,0,0,0
233230,application_1508364558011_10943,1,42883,42883,233230,190347,190347,5706,0,0,0
233230,application_1504131676014_25152,4,8310,8310,233230,224920,224920,9887,0,0,0
233360,application_1508364558011_42882,1,76815,76815,233360,156545,156545,5201,0,0,0
233360,application_1511528684064_1622,1,95908,95908,233360,137452,137452,5196,0,0,0
233390,application_1506638472019_33116,1,34066,34066,233390,199324,199324,6329,0,0,0
233450,application_1512440382012_4466,1,109938,109938,233450,123512,123512,4129,0,0,0
233510,application_1506638472019_35738,1,34987,34987,233510,198523,198523,6252,0,0,0
233540,application_1506638472019_36063,1,35118,35118,233540,198422,198422,6060,0,0,0
233560,application_1506638472019_36249,1,35148,35148,233560,198412,198412,5815,0,0,0
233640,application_1508364558011_0938,1,37990,37990,233640,195650,195650,6265,0,0,0
233750,application_1506638472019_36409,1,35211,35211,233750,198539,198539,6081,0,0,0
233790,application_1511528684064_1880,1,96077,96077,233790,137713,137713,5177,0,0,0
234080,application_1506638472019_36115,1,35129,35129,234080,198951,198951,6049,0,0,0
234260,application_1506638472019_38703,1,36660,36660,234260,197600,197600,6228,0,0,0
234470,application_1508364558011_48586,1,84585,84585,234470,149885,149885,6594,0,0,0
234510,application_1506638472019_5351,8,15876,15876,234510,218634,218634,5879,0,0,0
234540,application_1506638472019_35409,1,34932,34932,234540,199608,199608,5998,0,0,0
234560,application_1506638472019_36476,1,35226,35226,234560,199334,199334,6153,0,0,0
234570,application_1506638472019_36066,1,35119,35119,234570,199451,199451,6037,0,0,0
234590,application_1506638472019_36509,1,35233,35233,234590,199357,199357,6082,0,0,0
234850,application_1508364558011_7901,1,41592,41592,234850,193258,193258,6096,0,0,0
234890,application_1513627406021_1846,1,121361,121361,234890,113529,113529,4255,0,0,0
234950,application_1506638472019_36917,1,35497,35497,234950,199453,199453,5927,0,0,0
235250,application_1506638472019_35374,1,34926,34926,235250,200324,200324,6197,0,0,0
235270,application_1508364558011_6276,1,40582,40582,235270,194688,194688,6541,0,0,0
235380,application_1511528684064_1995,1,96091,96091,235380,139289,139289,5211,0,0,0
235450,application_1506638472019_25683,1,27880,27880,235450,207570,207570,6395,0,0,0
235570,application_1508364558011_30863,1,67245,67245,235570,168325,168325,5512,0,0,0
235570,application_1506638472019_36146,1,35135,35135,235570,200435,200435,6036,0,0,0
235650,application_1508364558011_0878,1,37987,37987,235650,197663,197663,6297,0,0,0
235750,application_1506638472019_36365,1,35203,35203,235750,200547,200547,5831,0,0,0
236240,application_1508364558011_36508,1,70814,70814,236240,165426,165426,5710,0,0,0
236510,application_1506638472019_36772,1,35372,35372,236510,201138,201138,6155,0,0,0
236780,application_1506638472019_36495,1,35229,35229,236780,201551,201551,6164,0,0,0
236830,application_1508364558011_37019,1,71983,71983,236830,164847,164847,6032,0,0,0
237250,application_1508364558011_48545,1,84577,84577,237250,152673,152673,5064,0,0,0
237500,application_1506638472019_29929,1,30616,30616,237500,206884,206884,8551,0,0,0
237510,application_1508364558011_23597,1,56071,56071,237510,181439,181439,5555,0,0,0
237570,application_1506638472019_36761,1,35370,35370,237570,202200,202200,5997,0,0,0
237610,application_1508364558011_22913,4,54898,54898,237610,182712,182712,4292,0,0,0
237820,application_1508364558011_30937,1,67304,67304,237820,170516,170516,7255,0,0,0
237840,application_1511528684064_1578,1,95840,95840,237840,142000,142000,5422,0,0,0
237890,application_1508364558011_50920,1,87275,87275,237890,150615,150615,5066,0,0,0
237980,application_1511528684064_2158,1,96175,96175,237980,141805,141805,5614,0,0,0
238000,application_1512440382012_4093,1,109870,109870,238000,128130,128130,4755,0,0,0
238100,application_1506638472019_36403,1,35210,35210,238100,202890,202890,6045,0,0,0
238820,application_1506638472019_35953,1,35055,35055,238820,203765,203765,5819,0,0,0
239220,application_1511528684064_1737,1,96009,96009,239220,143211,143211,5272,0,0,0
239230,application_1508364558011_50592,1,87234,87234,239230,151996,151996,5669,0,0,0
239660,application_1506638472019_36715,1,35362,35362,239660,204298,204298,6152,0,0,0
239850,application_1506638472019_36089,1,35123,35123,239850,204727,204727,6285,0,0,0
240050,application_1506638472019_36534,1,35237,35237,240050,204813,204813,6419,0,0,0
240350,application_1506638472019_36167,1,35140,35140,240350,205210,205210,6032,0,0,0
240360,application_1511528684064_2261,1,96190,96190,240360,144170,144170,5360,0,0,0
240400,application_1508364558011_50466,1,87199,87199,240400,153201,153201,5636,0,0,0
240760,application_1506638472019_4217,1,14658,14658,240760,226102,226102,7824,0,0,0
240850,application_1508364558011_28633,4,64590,64590,240850,176260,176260,4584,0,0,0
241230,application_1506638472019_33093,1,34065,34065,241230,207165,207165,6377,0,0,0
241410,application_1511528684064_1775,1,96063,96063,241410,145347,145347,5220,0,0,0
241480,application_1508364558011_51279,1,87343,87343,241480,154137,154137,5437,0,0,0
241510,application_1508364558011_7888,1,41589,41589,241510,199921,199921,6152,0,0,0
241590,application_1508364558011_26317,1,58700,58700,241590,182890,182890,6736,0,0,0
241720,application_1511528684064_1800,1,96066,96066,241720,145654,145654,5434,0,0,0
241760,application_1506638472019_35355,1,34923,34923,241760,206837,206837,5982,0,0,0
241840,application_1508364558011_51417,1,87473,87473,241840,154367,154367,5472,0,0,0
241870,application_1508364558011_36767,4,71348,71348,241870,170522,170522,4421,0,0,0
241910,application_1508364558011_52277,1,88189,88189,241910,153721,153721,5882,0,0,0
242010,application_1508364558011_50469,1,87199,87199,242010,154811,154811,5635,0,0,0
242100,application_1511528684064_1715,1,96006,96006,242100,146094,146094,5431,0,0,0
242150,application_1512440382012_3487,1,109686,109686,242150,132464,132464,4563,0,0,0
242330,application_1508364558011_51479,1,87482,87482,242330,154848,154848,5467,0,0,0
242470,application_1511528684064_2473,1,96248,96248,242470,146222,146222,5238,0,0,0
242500,application_1508364558011_45716,1,78559,78559,242500,163941,163941,5280,0,0,0
242790,application_1511528684064_2419,1,96242,96242,242790,146548,146548,5314,0,0,0
242870,application_1508364558011_51578,1,87496,87496,242870,155374,155374,5822,0,0,0
243070,application_1508364558011_6302,1,40584,40584,243070,202486,202486,6075,0,0,0
243230,application_1508364558011_51169,1,87302,87302,243230,155928,155928,5916,0,0,0
243230,application_1511528684064_1980,1,96089,96089,243230,147141,147141,5520,0,0,0
243390,application_1506638472019_35964,1,35058,35058,243390,208332,208332,6426,0,0,0
243390,application_1506638472019_9725,1,17669,17669,243390,225721,225721,8049,0,0,0
243640,application_1511528684064_2355,1,96220,96220,243640,147420,147420,5529,0,0,0
243660,application_1511528684064_2123,1,96107,96107,243660,147553,147553,5189,0,0,0
243900,application_1508364558011_51101,1,87294,87294,243900,156606,156606,5818,0,0,0
244110,application_1508364558011_51420,1,87473,87473,244110,156637,156637,5560,0,0,0
244540,application_1508364558011_22231,1,53237,53237,244540,191303,191303,6357,0,0,0
244590,application_1506638472019_14182,1,20123,20123,244590,224467,224467,6686,0,0,0
244600,application_1508364558011_51403,1,87472,87472,244600,157128,157128,5652,0,0,0
244630,application_1511528684064_1582,1,95841,95841,244630,148789,148789,5148,0,0,0
244810,application_1508364558011_50855,1,87267,87267,244810,157543,157543,5643,0,0,0
244820,application_1508364558011_0312,4,37467,37467,244820,207353,207353,5068,0,0,0
244860,application_1508364558011_12905,1,43773,43773,244860,201087,201087,6128,0,0,0
244870,application_1511528684064_2305,1,96211,96211,244870,148659,148659,5301,0,0,0
244950,application_1508364558011_14934,1,45536,45536,244950,199414,199414,5931,0,0,0
244980,application_1511528684064_2556,1,96310,96310,244980,148670,148670,5547,0,0,0
245230,application_1511528684064_2541,1,96309,96309,245230,148921,148921,5406,0,0,0
245230,application_1511528684064_2298,1,96209,96209,245230,149021,149021,5588,0,0,0
245260,application_1508364558011_51455,1,87479,87479,245260,157781,157781,5764,0,0,0
245460,application_1506638472019_33148,1,34112,34112,245460,211348,211348,6633,0,0,0
245500,application_1511528684064_2211,1,96182,96182,245500,149318,149318,5457,0,0,0
245670,application_1508364558011_51429,1,87475,87475,245670,158195,158195,5787,0,0,0
245730,application_1508364558011_30865,1,67246,67246,245730,178484,178484,6019,0,0,0
245980,application_1511528684064_2666,1,96328,96328,245980,149652,149652,5286,0,0,0
246300,application_1508364558011_47289,4,80485,80485,246300,165815,165815,4724,0,0,0
246310,application_1511528684064_2069,1,96101,96101,246310,150209,150209,5312,0,0,0
246650,application_1508364558011_14945,1,45536,45536,246650,201114,201114,5979,0,0,0
246760,application_1508364558011_50569,1,87230,87230,246760,159530,159530,5681,0,0,0
246880,application_1508364558011_50473,1,87200,87200,246880,159680,159680,5635,0,0,0
246880,application_1508364558011_51505,1,87484,87484,246880,159396,159396,5624,0,0,0
246890,application_1511528684064_2668,1,96329,96329,246890,150561,150561,5284,0,0,0
247120,application_1511528684064_2741,1,96364,96364,247120,150756,150756,5460,0,0,0
247440,application_1511528684064_1603,1,95845,95845,247440,151595,151595,5181,0,0,0
247500,application_1511528684064_1810,1,96067,96067,247500,151433,151433,5444,0,0,0
247530,application_1508364558011_26262,1,58672,58672,247530,188858,188858,5980,0,0,0
247530,application_1508364558011_41594,1,75152,75152,247530,172378,172378,5126,0,0,0
247570,application_1508364558011_6258,1,40582,40582,247570,206988,206988,6172,0,0,0
247590,application_1511528684064_1774,1,96063,96063,247590,151527,151527,5170,0,0,0
247630,application_1511528684064_1869,1,96075,96075,247630,151555,151555,5409,0,0,0
247780,application_1508364558011_21076,1,50407,50407,247780,197373,197373,6159,0,0,0
247880,application_1508364558011_26364,1,58712,58712,247880,189168,189168,6536,0,0,0
247980,application_1511528684064_1909,1,96080,96080,247980,151900,151900,5777,0,0,0
248220,application_1511528684064_1783,1,96064,96064,248220,152156,152156,5468,0,0,0
248230,application_1508364558011_51395,1,87470,87470,248230,160760,160760,5662,0,0,0
248730,application_1511528684064_1819,1,96068,96068,248730,152662,152662,5605,0,0,0
248740,application_1508364558011_52223,1,88184,88184,248740,160556,160556,5533,0,0,0
248740,application_1511528684064_1827,1,96069,96069,248740,152671,152671,5318,0,0,0
248890,application_1511528684064_2006,1,96092,96092,248890,152798,152798,5351,0,0,0
248900,application_1508364558011_37119,4,72112,72112,248900,176788,176788,5137,0,0,0
249000,application_1511528684064_1840,1,96072,96072,249000,152928,152928,5514,0,0,0
249200,application_1508364558011_12827,1,43746,43746,249200,205454,205454,6977,0,0,0
249200,application_1511528684064_1675,1,96001,96001,249200,153199,153199,5319,0,0,0
249420,application_1508364558011_6938,1,40930,40930,249420,208490,208490,6306,0,0,0
249480,application_1512440382012_1846,8,108318,108318,249480,141162,141162,4174,0,0,0
249490,application_1511528684064_2372,1,96224,96224,249490,153266,153266,5663,0,0,0
249600,application_1513627406021_0865,1,119481,119481,249600,130119,130119,5284,0,0,0
249640,application_1511528684064_2400,1,96239,96239,249640,153401,153401,5474,0,0,0
249670,application_1511528684064_2408,1,96240,96240,249670,153430,153430,5475,0,0,0
249820,application_1511528684064_2182,1,96178,96178,249820,153642,153642,5457,0,0,0
249840,application_1508364558011_51428,1,87474,87474,249840,162366,162366,5567,0,0,0
249870,application_1511528684064_1919,1,96081,96081,249870,153789,153789,5448,0,0,0
250010,application_1511528684064_1936,1,96084,96084,250010,153926,153926,5528,0,0,0
250070,application_1513627406021_0565,1,118699,118699,250070,131371,131371,5017,0,0,0
250080,application_1508364558011_50598,1,87234,87234,250080,162846,162846,5755,0,0,0
250080,application_1508364558011_40810,1,74447,74447,250080,175633,175633,6805,0,0,0
250250,application_1511528684064_1961,1,96087,96087,250250,154163,154163,5765,0,0,0
250320,application_1506638472019_34566,1,34615,34615,250320,215705,215705,8996,0,0,0
250540,application_1511528684064_2207,1,96182,96182,250540,154358,154358,5766,0,0,0
250640,application_1513627406021_0857,1,119476,119476,250640,131164,131164,5146,0,0,0
250690,application_1511528684064_1710,1,96005,96005,250690,154685,154685,5653,0,0,0
250710,application_1512440382012_2294,4,108791,108791,250710,141919,141919,4467,0,0,0
250740,application_1511528684064_2418,1,96242,96242,250740,154498,154498,5648,0,0,0
250830,application_1511528684064_1763,1,96015,96015,250830,154815,154815,5493,0,0,0
250850,application_1508364558011_51483,1,87482,87482,250850,163368,163368,5982,0,0,0
250960,application_1511528684064_2423,1,96242,96242,250960,154718,154718,5551,0,0,0
251080,application_1508364558011_51022,1,87286,87286,251080,163794,163794,5769,0,0,0
251100,application_1511528684064_1934,1,96083,96083,251100,155017,155017,5732,0,0,0
251150,application_1511528684064_2202,1,96181,96181,251150,154969,154969,5424,0,0,0
251300,application_1511528684064_2112,1,96106,96106,251300,155194,155194,5389,0,0,0
251360,application_1511528684064_1702,1,96004,96004,251360,155356,155356,5359,0,0,0
251410,application_1511528684064_2201,1,96181,96181,251410,155229,155229,5614,0,0,0
251630,application_1508364558011_7840,1,41587,41587,251630,210043,210043,6795,0,0,0
251660,application_1506638472019_16757,1,23285,23285,251660,228375,228375,7725,0,0,0
251730,application_1511528684064_2677,1,96330,96330,251730,155400,155400,5533,0,0,0
251790,application_1511528684064_1531,1,95673,95673,251790,156117,156117,6160,0,0,0
251920,application_1511528684064_2065,1,96100,96100,251920,155820,155820,5457,0,0,0
252100,application_1508364558011_51171,1,87302,87302,252100,164798,164798,5649,0,0,0
252210,application_1511528684064_1852,1,96073,96073,252210,156137,156137,5716,0,0,0
252250,application_1508364558011_51228,1,87310,87310,252250,164940,164940,5901,0,0,0
252250,application_1508364558011_52122,1,88171,88171,252250,164079,164079,5631,0,0,0
252360,application_1508364558011_37189,1,72267,72267,252360,180093,180093,6253,0,0,0
252570,application_1508364558011_52300,1,88192,88192,252570,164378,164378,5747,0,0,0
252650,application_1511528684064_1913,1,96081,96081,252650,156569,156569,5833,0,0,0
252660,application_1508364558011_50505,1,87222,87222,252660,165438,165438,5971,0,0,0
252660,application_1511528684064_2671,1,96329,96329,252660,156331,156331,5590,0,0,0
252660,application_1508364558011_48700,1,84689,84689,252660,167971,167971,5833,0,0,0
252670,application_1508364558011_52134,1,88173,88173,252670,164497,164497,5808,0,0,0
252710,application_1511916184019_0243,1,96884,96884,252710,155826,155826,5394,0,0,0
252730,application_1511528684064_2603,1,96317,96317,252730,156413,156413,5670,0,0,0
252790,application_1511916184019_0258,1,96886,96886,252790,155904,155904,5643,0,0,0
252790,application_1508364558011_51150,1,87300,87300,252790,165490,165490,5482,0,0,0
252990,application_1511528684064_1930,1,96083,96083,252990,156907,156907,5491,0,0,0
253160,application_1511528684064_1677,1,96001,96001,253160,157159,157159,5475,0,0,0
253230,application_1508364558011_51518,1,87486,87486,253230,165744,165744,5533,0,0,0
253340,application_1508364558011_51142,1,87298,87298,253340,166042,166042,5935,0,0,0
253380,application_1511528684064_2578,1,96313,96313,253380,157067,157067,5441,0,0,0
253380,application_1511528684064_2047,1,96098,96098,253380,157282,157282,5490,0,0,0
253460,application_1508364558011_51457,1,87479,87479,253460,165981,165981,5679,0,0,0
253530,application_1511528684064_2191,1,96179,96179,253530,157351,157351,5992,0,0,0
253540,application_1512440382012_2336,4,108931,108931,253540,144609,144609,4420,0,0,0
253860,application_1508364558011_51477,1,87481,87481,253860,166379,166379,5948,0,0,0
254040,application_1511528684064_1891,1,96078,96078,254040,157962,157962,5581,0,0,0
254190,application_1511916184019_0399,1,97359,97359,254190,156831,156831,5800,0,0,0
254250,application_1508364558011_50597,1,87234,87234,254250,167016,167016,6102,0,0,0
254360,application_1511528684064_1739,1,96009,96009,254360,158351,158351,5245,0,0,0
254580,application_1511528684064_2619,1,96319,96319,254580,158261,158261,5490,0,0,0
254600,application_1511528684064_2016,1,96094,96094,254600,158506,158506,5494,0,0,0
254780,application_1511528684064_2706,1,96337,96337,254780,158443,158443,5466,0,0,0
254820,application_1508364558011_26369,1,58712,58712,254820,196108,196108,7641,0,0,0
254950,application_1508364558011_51515,1,87485,87485,254950,167465,167465,5783,0,0,0
255020,application_1508364558011_50896,1,87272,87272,255020,167748,167748,5970,0,0,0
255100,application_1508364558011_6300,1,40583,40583,255100,214517,214517,7430,0,0,0
255160,application_1511916184019_0245,1,96884,96884,255160,158276,158276,5482,0,0,0
255170,application_1508364558011_45659,1,78426,78426,255170,176744,176744,6043,0,0,0
255490,application_1508364558011_52655,1,88860,88860,255490,166630,166630,5589,0,0,0
255590,application_1504131676014_24966,8,7536,7536,255590,248054,248054,11684,0,0,0
255630,application_1508364558011_27049,1,59834,59834,255630,195796,195796,6757,0,0,0
255660,application_1508364558011_14659,1,45189,45189,255660,210471,210471,6500,0,0,0
255690,application_1511528684064_1716,1,96006,96006,255690,159684,159684,5827,0,0,0
255740,application_1508364558011_50532,1,87225,87225,255740,168515,168515,5808,0,0,0
255800,application_1508364558011_50996,1,87283,87283,255800,168517,168517,5884,0,0,0
255830,application_1508364558011_52631,1,88857,88857,255830,166973,166973,5593,0,0,0
255960,application_1506638472019_21292,1,26249,26249,255960,229711,229711,8003,0,0,0
255990,application_1511528684064_1928,1,96082,96082,255990,159908,159908,5591,0,0,0
256470,application_1511528684064_1905,1,96080,96080,256470,160390,160390,5741,0,0,0
256540,application_1506638472019_24087,1,27340,27340,256540,229200,229200,8128,0,0,0
256560,application_1508364558011_50530,1,87225,87225,256560,169335,169335,5940,0,0,0
256690,application_1511528684064_1969,1,96088,96088,256690,160602,160602,5458,0,0,0
256870,application_1506638472019_29943,1,30620,30620,256870,226250,226250,8261,0,0,0
257000,application_1511528684064_2177,1,96177,96177,257000,160823,160823,5765,0,0,0
257030,application_1511528684064_2605,1,96317,96317,257030,160713,160713,5589,0,0,0
257070,application_1508364558011_51057,1,87289,87289,257070,169781,169781,5987,0,0,0
257100,application_1511528684064_2639,1,96324,96324,257100,160776,160776,5445,0,0,0
257100,application_1511528684064_2399,1,96239,96239,257100,160861,160861,5584,0,0,0
257150,application_1508364558011_52165,1,88177,88177,257150,168973,168973,5822,0,0,0
257220,application_1511528684064_2247,1,96188,96188,257220,161032,161032,5687,0,0,0
257250,application_1511528684064_1790,1,96065,96065,257250,161185,161185,5740,0,0,0
257400,application_1511528684064_1958,1,96086,96086,257400,161314,161314,5482,0,0,0
257450,application_1508364558011_50593,1,87234,87234,257450,170216,170216,6038,0,0,0
257530,application_1506638472019_38724,1,36725,36725,257530,220805,220805,7691,0,0,0
257600,application_1506638472019_31753,1,31994,31994,257600,225606,225606,8177,0,0,0
257670,application_1511528684064_2539,1,96309,96309,257670,161361,161361,5349,0,0,0
257710,application_1508364558011_48585,1,84585,84585,257710,173125,173125,6311,0,0,0
257770,application_1508364558011_37110,4,72107,72107,257770,185663,185663,5965,0,0,0
257780,application_1511528684064_1850,1,96073,96073,257780,161707,161707,5820,0,0,0
257800,application_1511528684064_2089,1,96103,96103,257800,161697,161697,5868,0,0,0
257880,application_1508364558011_26791,4,59424,59424,257880,198456,198456,4895,0,0,0
258000,application_1511528684064_1887,1,96077,96077,258000,161923,161923,5711,0,0,0
258360,application_1511528684064_1954,1,96086,96086,258360,162274,162274,5443,0,0,0
258430,application_1508364558011_51398,1,87471,87471,258430,170959,170959,5823,0,0,0
258520,application_1511528684064_2113,1,96106,96106,258520,162414,162414,5395,0,0,0
258530,application_1508364558011_51463,1,87480,87480,258530,171050,171050,5694,0,0,0
258730,application_1506638472019_29881,1,30607,30607,258730,228123,228123,8173,0,0,0
259140,application_1506638472019_31652,1,31739,31739,259140,227401,227401,7152,0,0,0
259170,application_1506638472019_5899,1,16071,16071,259170,243099,243099,8520,0,0,0
259350,application_1511528684064_1926,1,96082,96082,259350,163268,163268,5805,0,0,0
259390,application_1508364558011_51177,1,87303,87303,259390,172087,172087,5879,0,0,0
259400,application_1511916184019_2284,1,101134,101134,259400,158266,158266,5745,0,0,0
259810,application_1508364558011_50484,1,87201,87201,259810,172609,172609,6066,0,0,0
259810,application_1508364558011_50987,1,87282,87282,259810,172528,172528,5827,0,0,0
259930,application_1508364558011_50788,1,87259,87259,259930,172671,172671,5926,0,0,0
260010,application_1508364558011_7937,1,41599,41599,260010,218411,218411,7705,0,0,0
260030,application_1508364558011_52663,1,88861,88861,260030,171169,171169,5755,0,0,0
260030,application_1508364558011_46366,8,79289,79289,260030,180741,180741,4760,0,0,0
260390,application_1508364558011_50590,1,87233,87233,260390,173157,173157,6044,0,0,0
260400,application_1506638472019_31149,1,31172,31172,260400,229228,229228,7965,0,0,0
260690,application_1513025660013_0816,4,116339,116339,260690,144351,144351,4572,0,0,0
260940,application_1506638472019_31088,1,31158,31158,260940,229782,229782,8100,0,0,0
261540,application_1511916184019_1100,1,98832,98832,261540,162708,162708,5424,0,0,0
261550,application_1506638472019_29908,1,30613,30613,261550,230937,230937,8148,0,0,0
261630,application_1506638472019_10448,1,18502,18502,261630,243128,243128,8222,0,0,0
261850,application_1508364558011_22306,4,53437,53437,261850,208413,208413,5320,0,0,0
262130,application_1506638472019_31080,1,31157,31157,262130,230973,230973,7902,0,0,0
262250,application_1508364558011_19064,1,48370,48370,262250,213880,213880,7611,0,0,0
262370,application_1508364558011_50497,1,87204,87204,262370,175166,175166,6226,0,0,0
262630,application_1512440382012_1606,1,107986,107986,262630,154644,154644,6141,0,0,0
262650,application_1508364558011_51223,1,87309,87309,262650,175341,175341,5851,0,0,0
262670,application_1511528684064_1883,1,96077,96077,262670,166593,166593,5778,0,0,0
263000,application_1508364558011_51438,1,87477,87477,263000,175523,175523,6081,0,0,0
263170,application_1508364558011_50440,1,87195,87195,263170,175975,175975,6116,0,0,0
263300,application_1508364558011_40833,1,74449,74449,263300,188851,188851,6850,0,0,0
263470,application_1513627406021_2447,1,122370,122370,263470,141100,141100,5657,0,0,0
263500,application_1506638472019_29902,1,30611,30611,263500,232889,232889,8132,0,0,0
263560,application_1506638472019_29900,1,30611,30611,263560,232949,232949,8220,0,0,0
263830,application_1506638472019_31653,1,31739,31739,263830,232091,232091,8179,0,0,0
263830,application_1508364558011_7932,1,41599,41599,263830,222231,222231,7609,0,0,0
264030,application_1508364558011_27835,1,61912,61912,264030,202118,202118,6899,0,0,0
264400,application_1506638472019_31120,1,31164,31164,264400,233236,233236,8385,0,0,0
264570,application_1512440382012_1346,4,107371,107371,264570,157199,157199,6122,0,0,0
264580,application_1508364558011_7857,1,41588,41588,264580,222992,222992,7149,0,0,0
264870,application_1508364558011_51468,1,87480,87480,264870,177390,177390,5881,0,0,0
265060,application_1508364558011_51399,1,87471,87471,265060,177589,177589,5945,0,0,0
265510,application_1508364558011_6043,1,40290,40290,265510,225220,225220,7056,0,0,0
265770,application_1508364558011_0932,1,37990,37990,265770,227780,227780,8109,0,0,0
265870,application_1508364558011_40832,1,74449,74449,265870,191421,191421,7810,0,0,0
265880,application_1508364558011_47249,1,80454,80454,265880,185426,185426,6568,0,0,0
266050,application_1508364558011_50809,1,87262,87262,266050,178788,178788,5967,0,0,0
266110,application_1512440382012_6368,2,114131,114131,266110,151979,151979,9609,0,0,0
266360,application_1506638472019_29958,1,30627,30627,266360,235733,235733,7970,0,0,0
266450,application_1506638472019_15127,1,22006,22006,266450,244444,244444,10443,0,0,0
266480,application_1508364558011_50432,1,87194,87194,266480,179286,179286,6264,0,0,0
266550,application_1506638472019_29954,1,30625,30625,266550,235925,235925,8164,0,0,0
267150,application_1508364558011_13238,1,44228,44228,267150,222922,222922,7371,0,0,0
267200,application_1508364558011_50894,1,87272,87272,267200,179928,179928,6536,0,0,0
267440,application_1508364558011_50430,1,87194,87194,267440,180246,180246,6176,0,0,0
267960,application_1511528684064_1863,1,96075,96075,267960,171885,171885,5803,0,0,0
268030,application_1513627406021_2448,1,122371,122371,268030,145659,145659,5615,0,0,0
268160,application_1504131676014_20926,16,3444,3444,268160,264716,264716,70438,0,0,0
268330,application_1506638472019_29904,1,30612,30612,268330,237718,237718,8396,0,0,0
268530,application_1508364558011_0946,1,37991,37991,268530,230539,230539,8436,0,0,0
268900,application_1511916184019_0805,8,98196,98196,268900,170704,170704,5192,0,0,0
269070,application_1508364558011_22563,1,54289,54289,269070,214781,214781,7304,0,0,0
269200,application_1506638472019_31117,1,31163,31163,269200,238037,238037,8130,0,0,0
269540,application_1506638472019_15277,1,22278,22278,269540,247262,247262,10421,0,0,0
269550,application_1508364558011_52688,1,88915,88915,269550,180635,180635,6570,0,0,0
269600,application_1506638472019_24073,1,27336,27336,269600,242264,242264,8121,0,0,0
269670,application_1508364558011_21879,4,51680,51680,269670,217990,217990,6474,0,0,0
269760,application_1506638472019_34564,1,34615,34615,269760,235145,235145,8854,0,0,0
269770,application_1506638472019_32771,1,33437,33437,269770,236333,236333,9561,0,0,0
270300,application_1506638472019_31105,1,31161,31161,270300,239139,239139,7866,0,0,0
271020,application_1512440382012_5813,1,112305,112305,271020,158715,158715,6496,0,0,0
271590,application_1508364558011_27834,1,61912,61912,271590,209678,209678,7064,0,0,0
272000,application_1506638472019_31114,1,31163,31163,272000,240837,240837,8479,0,0,0
272270,application_1508364558011_40828,1,74449,74449,272270,197821,197821,7078,0,0,0
272430,application_1506638472019_38701,1,36659,36659,272430,235771,235771,8691,0,0,0
272460,application_1506638472019_35494,1,34944,34944,272460,237516,237516,8515,0,0,0
272590,application_1508364558011_50182,4,86767,86767,272590,185823,185823,5897,0,0,0
272930,application_1506638472019_29750,1,30242,30242,272930,242688,242688,8425,0,0,0
273130,application_1506638472019_38532,1,36293,36293,273130,236837,236837,8336,0,0,0
273250,application_1508364558011_51383,1,87468,87468,273250,185782,185782,9645,0,0,0
273570,application_1506638472019_32764,1,33436,33436,273570,240134,240134,8368,0,0,0
273590,application_1508364558011_40802,1,74447,74447,273590,199143,199143,8956,0,0,0
273710,application_1508364558011_7921,1,41599,41599,273710,232111,232111,7725,0,0,0
274070,application_1506638472019_34580,1,34618,34618,274070,239452,239452,8926,0,0,0
274260,application_1508364558011_14999,1,45542,45542,274260,228718,228718,8318,0,0,0
274480,application_1506638472019_31125,1,31164,31164,274480,243316,243316,8487,0,0,0
274820,application_1506638472019_34543,1,34608,34608,274820,240212,240212,8856,0,0,0
274930,application_1506638472019_20326,1,25660,25660,274930,249270,249270,8809,0,0,0
274940,application_1508364558011_40852,1,74450,74450,274940,200490,200490,7292,0,0,0
275520,application_1506638472019_31134,1,31167,31167,275520,244353,244353,8672,0,0,0
275780,application_1508364558011_27045,1,59833,59833,275780,215947,215947,7604,0,0,0
276090,application_1511528684064_2482,1,96250,96250,276090,179840,179840,8881,0,0,0
276160,application_1508364558011_33746,1,69636,69636,276160,206524,206524,7353,0,0,0
276360,application_1512440382012_1605,1,107986,107986,276360,168374,168374,6216,0,0,0
276750,application_1508364558011_25626,8,57558,57558,276750,219192,219192,6911,0,0,0
276790,application_1506638472019_31099,1,31160,31160,276790,245630,245630,8432,0,0,0
276970,application_1506638472019_29883,1,30607,30607,276970,246363,246363,8377,0,0,0
277490,application_1508364558011_14617,1,45187,45187,277490,232303,232303,8192,0,0,0
277600,application_1508364558011_0879,1,37987,37987,277600,239613,239613,8306,0,0,0
277710,application_1508364558011_0923,1,37989,37989,277710,239721,239721,8270,0,0,0
277790,application_1506638472019_29872,1,30605,30605,277790,247185,247185,8443,0,0,0
278540,application_1512440382012_0108,8,105271,105271,278540,173269,173269,7068,0,0,0
278660,application_1508364558011_36619,4,70978,70978,278660,207682,207682,6264,0,0,0
279120,application_1512440382012_0431,4,105786,105786,279120,173334,173334,5867,0,0,0
279330,application_1506638472019_29920,1,30615,30615,279330,248715,248715,8423,0,0,0
279540,application_1508364558011_14623,1,45187,45187,279540,234353,234353,8898,0,0,0
279560,application_1508364558011_7880,1,41589,41589,279560,237971,237971,8255,0,0,0
279800,application_1506638472019_34585,1,34619,34619,279800,245181,245181,8751,0,0,0
279850,application_1508364558011_40823,1,74448,74448,279850,205402,205402,6981,0,0,0
280060,application_1506638472019_34770,1,34639,34639,280060,245421,245421,10092,0,0,0
280350,application_1512440382012_1309,4,107296,107296,280350,173054,173054,6298,0,0,0
282040,application_1508364558011_43162,1,77313,77313,282040,204727,204727,8798,0,0,0
282340,application_1508364558011_14638,1,45188,45188,282340,237152,237152,8168,0,0,0
282450,application_1506638472019_34550,1,34612,34612,282450,247838,247838,9029,0,0,0
283020,application_1511528684064_2700,1,96333,96333,283020,186687,186687,8901,0,0,0
283740,application_1506638472019_34598,1,34621,34621,283740,249119,249119,8975,0,0,0
284020,application_1506638472019_34538,1,34606,34606,284020,249414,249414,9092,0,0,0
284030,application_1511916184019_3789,1,105129,105129,284030,178901,178901,7322,0,0,0
284050,application_1506638472019_35522,1,34947,34947,284050,249103,249103,8625,0,0,0
284150,application_1506638472019_15875,1,22560,22560,284150,261590,261590,10394,0,0,0
284180,application_1508364558011_50763,1,87256,87256,284180,196924,196924,8883,0,0,0
284780,application_1512440382012_2994,1,109604,109604,284780,175176,175176,7785,0,0,0
284970,application_1508364558011_14609,1,45187,45187,284970,239783,239783,8226,0,0,0
285110,application_1506638472019_15594,1,22502,22502,285110,262608,262608,10297,0,0,0
285310,application_1506638472019_24823,1,27754,27754,285310,257556,257556,9873,0,0,0
285530,application_1508364558011_32800,1,69059,69059,285530,216471,216471,8490,0,0,0
285810,application_1508364558011_47768,1,81408,81408,285810,204402,204402,8684,0,0,0
286380,application_1508364558011_14635,1,45188,45188,286380,241192,241192,8432,0,0,0
286550,application_1506638472019_35984,1,35060,35060,286550,251490,251490,9533,0,0,0
287070,application_1508364558011_7519,1,41407,41407,287070,245663,245663,8416,0,0,0
287410,application_1506638472019_15168,1,22014,22014,287410,265396,265396,10314,0,0,0
287560,application_1508364558011_50738,1,87253,87253,287560,200307,200307,8838,0,0,0
287770,application_1513025660013_0166,1,115209,115209,287770,172561,172561,7028,0,0,0
288640,application_1511528684064_2046,1,96098,96098,288640,192542,192542,8737,0,0,0
288790,application_1506638472019_14973,1,21976,21976,288790,266814,266814,10382,0,0,0
288880,application_1506638472019_35458,1,34940,34940,288880,253940,253940,8548,0,0,0
289680,application_1506638472019_15507,1,22487,22487,289680,267193,267193,10538,0,0,0
289910,application_1506638472019_31086,1,31158,31158,289910,258752,258752,8790,0,0,0
290050,application_1506638472019_32718,1,33434,33434,290050,256616,256616,9704,0,0,0
290160,application_1506638472019_15766,1,22539,22539,290160,267621,267621,10706,0,0,0
290390,application_1506638472019_34111,1,34422,34422,290390,255968,255968,9565,0,0,0
290850,application_1506638472019_15292,1,22281,22281,290850,268569,268569,10610,0,0,0
291230,application_1506638472019_25926,1,27965,27965,291230,263265,263265,10959,0,0,0
291280,application_1506638472019_15823,1,22550,22550,291280,268730,268730,10652,0,0,0
291570,application_1508364558011_50646,1,87243,87243,291570,204327,204327,8848,0,0,0
291850,application_1506638472019_35204,1,34888,34888,291850,256962,256962,9073,0,0,0
291890,application_1506638472019_15046,1,21989,21989,291890,269901,269901,10715,0,0,0
292260,application_1506638472019_25466,1,27841,27841,292260,264419,264419,10345,0,0,0
292330,application_1506638472019_15774,1,22541,22541,292330,269789,269789,10289,0,0,0
292370,application_1506638472019_34572,1,34616,34616,292370,257754,257754,9061,0,0,0
292560,application_1512440382012_3039,1,109611,109611,292560,182949,182949,8147,0,0,0
292940,application_1506638472019_14952,1,21973,21973,292940,270967,270967,11090,0,0,0
293060,application_1508364558011_0637,1,37773,37773,293060,255287,255287,9261,0,0,0
293160,application_1506638472019_15768,1,22539,22539,293160,270621,270621,10421,0,0,0
293210,application_1506638472019_34561,1,34614,34614,293210,258596,258596,9020,0,0,0
293380,application_1506638472019_33109,1,34066,34066,293380,259314,259314,8836,0,0,0
293440,application_1506638472019_15483,1,22481,22481,293440,270959,270959,10361,0,0,0
293520,application_1508364558011_47655,1,80984,80984,293520,212536,212536,7882,0,0,0
293630,application_1506638472019_15135,1,22007,22007,293630,271623,271623,10962,0,0,0
293800,application_1508364558011_50953,1,87279,87279,293800,206521,206521,8847,0,0,0
294240,application_1508364558011_19054,1,48369,48369,294240,245871,245871,8736,0,0,0
294760,application_1512440382012_3071,1,109619,109619,294760,185141,185141,8130,0,0,0
294840,application_1506638472019_15190,1,22019,22019,294840,272821,272821,10235,0,0,0
295180,application_1512440382012_5824,1,112314,112314,295180,182866,182866,7324,0,0,0
295220,application_1506638472019_15203,1,22023,22023,295220,273197,273197,10870,0,0,0
295270,application_1506638472019_15670,1,22519,22519,295270,272751,272751,10747,0,0,0
295370,application_1508364558011_51612,1,87500,87500,295370,207870,207870,8503,0,0,0
295890,application_1512440382012_5029,1,110417,110417,295890,185473,185473,7608,0,0,0
296240,application_1508364558011_7873,1,41589,41589,296240,254651,254651,9158,0,0,0
296540,application_1508364558011_48889,1,84944,84944,296540,211596,211596,8143,0,0,0
296950,application_1506638472019_15783,1,22543,22543,296950,274407,274407,10214,0,0,0
296960,application_1506638472019_15026,1,21986,21986,296960,274974,274974,10640,0,0,0
297120,application_1506638472019_34836,1,34645,34645,297120,262475,262475,10115,0,0,0
297620,application_1506638472019_24783,1,27746,27746,297620,269874,269874,10498,0,0,0
297880,application_1508364558011_51175,1,87303,87303,297880,210577,210577,8979,0,0,0
297980,application_1508364558011_27391,16,60362,60362,297980,237618,237618,21137,0,0,0
298060,application_1512440382012_2778,1,109578,109578,298060,188482,188482,8282,0,0,0
298120,application_1506638472019_29941,1,30620,30620,298120,267500,267500,10203,0,0,0
298290,application_1506638472019_14894,1,21961,21961,298290,276329,276329,10295,0,0,0
298970,application_1511528684064_0897,8,94225,94225,298970,204745,204745,7662,0,0,0
299000,application_1506638472019_14901,1,21963,21963,299000,277037,277037,10206,0,0,0
299190,application_1513627406021_1259,1,120367,120367,299190,178823,178823,7692,0,0,0
299390,application_1508364558011_19097,1,48372,48372,299390,251018,251018,9478,0,0,0
299450,application_1512440382012_3221,1,109652,109652,299450,189798,189798,7916,0,0,0
299710,application_1506638472019_23989,1,27317,27317,299710,272393,272393,9563,0,0,0
299780,application_1506638472019_14951,1,21972,21972,299780,277808,277808,11080,0,0,0
300060,application_1506638472019_15383,1,22299,22299,300060,277761,277761,10743,0,0,0
300370,application_1506638472019_32749,1,33435,33435,300370,266935,266935,9173,0,0,0
300730,application_1511528684064_2475,1,96248,96248,300730,204482,204482,8642,0,0,0
300810,application_1511528684064_2524,1,96306,96306,300810,204504,204504,8575,0,0,0
300820,application_1506638472019_25845,1,27945,27945,300820,272875,272875,10270,0,0,0
300830,application_1506638472019_15152,1,22011,22011,300830,278819,278819,10437,0,0,0
300840,application_1508364558011_48408,4,84529,84529,300840,216311,216311,7457,0,0,0
300970,application_1508364558011_51499,1,87484,87484,300970,213486,213486,8817,0,0,0
301180,application_1506638472019_15213,1,22027,22027,301180,279153,279153,10722,0,0,0
301190,application_1511528684064_2496,1,96255,96255,301190,204935,204935,8580,0,0,0
301590,application_1506638472019_24653,1,27722,27722,301590,273868,273868,10326,0,0,0
301910,application_1506638472019_15656,1,22516,22516,301910,279394,279394,10326,0,0,0
302200,application_1506638472019_15697,1,22525,22525,302200,279675,279675,10227,0,0,0
302250,application_1508364558011_52197,1,88181,88181,302250,214069,214069,9044,0,0,0
302270,application_1513025660013_0549,1,115748,115748,302270,186522,186522,7968,0,0,0
302300,application_1512440382012_2989,1,109604,109604,302300,192696,192696,8223,0,0,0
302470,application_1506638472019_15139,1,22008,22008,302470,280462,280462,10137,0,0,0
302650,application_1508364558011_26356,1,58710,58710,302650,243940,243940,9536,0,0,0
302720,application_1511528684064_2749,1,96372,96372,302720,206348,206348,8999,0,0,0
302980,application_1512440382012_3022,1,109608,109608,302980,193372,193372,8426,0,0,0
303160,application_1508364558011_53036,1,89736,89736,303160,213424,213424,8761,0,0,0
303300,application_1511528684064_2459,1,96246,96246,303300,207054,207054,8558,0,0,0
303740,application_1511528684064_2691,1,96332,96332,303740,207408,207408,8845,0,0,0
304420,application_1506638472019_15743,1,22535,22535,304420,281885,281885,10364,0,0,0
304420,application_1506638472019_26125,1,28048,28048,304420,276372,276372,10273,0,0,0
304420,application_1508364558011_50580,1,87232,87232,304420,217188,217188,9457,0,0,0
304460,application_1506638472019_15689,1,22522,22522,304460,281938,281938,10331,0,0,0
304490,application_1506638472019_32758,1,33435,33435,304490,271055,271055,10742,0,0,0
304890,application_1511916184019_2515,1,101773,101773,304890,203117,203117,9152,0,0,0
305090,application_1506638472019_15493,1,22483,22483,305090,282607,282607,10762,0,0,0
305250,application_1506638472019_32777,1,33437,33437,305250,271813,271813,9565,0,0,0
305590,application_1511528684064_2595,1,96315,96315,305590,209275,209275,8613,0,0,0
305620,application_1508364558011_50611,1,87236,87236,305620,218384,218384,9021,0,0,0
305630,application_1508364558011_21641,1,50878,50878,305630,254752,254752,10297,0,0,0
305830,application_1506638472019_15634,1,22510,22510,305830,283320,283320,10658,0,0,0
305910,application_1508364558011_50961,1,87279,87279,305910,218631,218631,8859,0,0,0
305930,application_1506638472019_34773,1,34640,34640,305930,271290,271290,10006,0,0,0
305930,application_1508364558011_42998,8,76985,76985,305930,228945,228945,7283,0,0,0
305940,application_1508364558011_50869,1,87269,87269,305940,218671,218671,9447,0,0,0
306040,application_1506638472019_34720,1,34633,34633,306040,271407,271407,9619,0,0,0
306090,application_1508364558011_51573,1,87494,87494,306090,218596,218596,8805,0,0,0
306100,application_1506638472019_24760,1,27742,27742,306100,278358,278358,10314,0,0,0
306270,application_1511528684064_2751,1,96383,96383,306270,209887,209887,8524,0,0,0
306360,application_1508364558011_50689,1,87248,87248,306360,219112,219112,9187,0,0,0
306360,application_1511916184019_0298,1,96945,96945,306360,209415,209415,10542,0,0,0
306360,application_1511528684064_2190,1,96179,96179,306360,210181,210181,8902,0,0,0
306530,application_1512440382012_2942,1,109599,109599,306530,196931,196931,8374,0,0,0
306530,application_1508364558011_52173,1,88177,88177,306530,218353,218353,9194,0,0,0
306590,application_1506638472019_15956,1,22576,22576,306590,284014,284014,11068,0,0,0
306660,application_1506638472019_37567,1,35962,35962,306660,270698,270698,10550,0,0,0
306960,application_1508364558011_50826,1,87264,87264,306960,219696,219696,8916,0,0,0
306970,application_1512440382012_3640,1,109718,109718,306970,197252,197252,8174,0,0,0
307130,application_1506638472019_31141,1,31169,31169,307130,275961,275961,11982,0,0,0
307500,application_1506638472019_26234,1,28097,28097,307500,279403,279403,10311,0,0,0
307520,application_1506638472019_35482,1,34943,34943,307520,272577,272577,9930,0,0,0
307600,application_1506638472019_24121,1,27344,27344,307600,280256,280256,10933,0,0,0
307740,application_1506638472019_15386,1,22299,22299,307740,285441,285441,10576,0,0,0
307790,application_1506638472019_26150,1,28055,28055,307790,279735,279735,10508,0,0,0
307930,application_1506638472019_15089,1,21998,21998,307930,285932,285932,10744,0,0,0
308120,application_1511916184019_0446,1,97565,97565,308120,210555,210555,8351,0,0,0
308260,application_1508364558011_50907,1,87274,87274,308260,220986,220986,9006,0,0,0
308460,application_1508364558011_51706,1,87595,87595,308460,220865,220865,8961,0,0,0
308530,application_1508364558011_4005,1,39314,39314,308530,269216,269216,10235,0,0,0
308560,application_1508364558011_51379,1,87467,87467,308560,221093,221093,9154,0,0,0
308580,application_1511528684064_2736,1,96362,96362,308580,212218,212218,8647,0,0,0
308590,application_1508364558011_51151,1,87300,87300,308590,221290,221290,9111,0,0,0
308650,application_1506638472019_15289,1,22280,22280,308650,286370,286370,11202,0,0,0
308660,application_1506638472019_15933,1,22571,22571,308660,286089,286089,10730,0,0,0
308900,application_1511528684064_2219,1,96183,96183,308900,212717,212717,8978,0,0,0
308940,application_1506638472019_15841,1,22553,22553,308940,286387,286387,10396,0,0,0
308980,application_1506638472019_15171,1,22015,22015,308980,286965,286965,10673,0,0,0
309080,application_1506638472019_25318,1,27820,27820,309080,281260,281260,10743,0,0,0
309290,application_1506638472019_34848,1,34646,34646,309290,274644,274644,10340,0,0,0
309350,application_1508364558011_51209,1,87307,87307,309350,222043,222043,8995,0,0,0
309720,application_1506638472019_31067,1,31155,31155,309720,278565,278565,10921,0,0,0
309890,application_1506638472019_15120,1,22004,22004,309890,287886,287886,10297,0,0,0
310070,application_1506638472019_15752,1,22536,22536,310070,287534,287534,11262,0,0,0
310210,application_1506638472019_34743,1,34636,34636,310210,275574,275574,9670,0,0,0
310230,application_1506638472019_35428,1,34936,34936,310230,275294,275294,13226,0,0,0
310240,application_1506638472019_15969,1,22578,22578,310240,287662,287662,10886,0,0,0
310290,application_1511528684064_2718,1,96359,96359,310290,213931,213931,8770,0,0,0
310940,application_1508364558011_40809,1,74447,74447,310940,236493,236493,9473,0,0,0
310970,application_1511528684064_2717,1,96359,96359,310970,214611,214611,8781,0,0,0
311040,application_1508364558011_50958,1,87279,87279,311040,223761,223761,9196,0,0,0
311420,application_1506638472019_15793,1,22545,22545,311420,288875,288875,10845,0,0,0
311590,application_1506638472019_15931,1,22571,22571,311590,289019,289019,11106,0,0,0
311600,application_1508364558011_52671,1,88863,88863,311600,222737,222737,9092,0,0,0
311780,application_1506638472019_35351,1,34922,34922,311780,276858,276858,11629,0,0,0
311780,application_1508364558011_40615,1,74025,74025,311780,237755,237755,9261,0,0,0
311890,application_1506638472019_4011,4,14269,14269,311890,297621,297621,11730,0,0,0
311900,application_1508364558011_50863,1,87268,87268,311900,224632,224632,9135,0,0,0
311940,application_1506638472019_35989,1,35061,35061,311940,276879,276879,10020,0,0,0
311960,application_1512440382012_5575,1,111017,111017,311960,200943,200943,8905,0,0,0
312130,application_1506638472019_15784,1,22543,22543,312130,289587,289587,10841,0,0,0
312250,application_1506638472019_15184,1,22017,22017,312250,290233,290233,10978,0,0,0
312380,application_1506638472019_15925,1,22569,22569,312380,289811,289811,10788,0,0,0
312440,application_1508364558011_51617,1,87501,87501,312440,224939,224939,9318,0,0,0
312490,application_1508364558011_37146,4,72150,72150,312490,240340,240340,8294,0,0,0
312530,application_1508364558011_50898,1,87272,87272,312530,225258,225258,9122,0,0,0
312550,application_1508364558011_30808,1,67131,67131,312550,245419,245419,9663,0,0,0
312640,application_1506638472019_36629,1,35343,35343,312640,277297,277297,13137,0,0,0
312780,application_1506638472019_32762,1,33436,33436,312780,279344,279344,10669,0,0,0
312860,application_1508364558011_50564,1,87230,87230,312860,225630,225630,9251,0,0,0
312870,application_1508364558011_51487,1,87482,87482,312870,225388,225388,9009,0,0,0
313020,application_1506638472019_15557,1,22496,22496,313020,290524,290524,11440,0,0,0
313020,application_1508364558011_51408,1,87472,87472,313020,225548,225548,8839,0,0,0
313130,application_1508364558011_7953,1,41600,41600,313130,271530,271530,11079,0,0,0
313270,application_1506638472019_15734,1,22533,22533,313270,290737,290737,11197,0,0,0
313620,application_1508364558011_50621,1,87237,87237,313620,226383,226383,9418,0,0,0
313740,application_1506638472019_20311,1,25641,25641,313740,288099,288099,11143,0,0,0
313910,application_1506638472019_26203,1,28069,28069,313910,285841,285841,11104,0,0,0
313950,application_1506638472019_15611,1,22505,22505,313950,291445,291445,11267,0,0,0
313970,application_1506638472019_24597,1,27710,27710,313970,286260,286260,11241,0,0,0
314080,application_1512440382012_2951,1,109601,109601,314080,204479,204479,8815,0,0,0
314220,application_1508364558011_43511,1,77850,77850,314220,236370,236370,10283,0,0,0
314260,application_1508364558011_51503,1,87484,87484,314260,226776,226776,9259,0,0,0
314300,application_1508364558011_32522,1,68708,68708,314300,245592,245592,10565,0,0,0
314360,application_1508364558011_50639,1,87242,87242,314360,227118,227118,9118,0,0,0
314360,application_1508364558011_50983,1,87282,87282,314360,227078,227078,9145,0,0,0
314400,application_1506638472019_36870,1,35487,35487,314400,278913,278913,11438,0,0,0
314410,application_1508364558011_21608,1,50843,50843,314410,263567,263567,10108,0,0,0
314460,application_1508364558011_4480,1,39427,39427,314460,275033,275033,10150,0,0,0
314840,application_1506638472019_25921,1,27964,27964,314840,286876,286876,11252,0,0,0
314990,application_1508364558011_51207,1,87307,87307,314990,227683,227683,8994,0,0,0
315340,application_1506638472019_15385,1,22299,22299,315340,293041,293041,11169,0,0,0
315610,application_1506638472019_25682,1,27880,27880,315610,287730,287730,10869,0,0,0
315800,application_1508364558011_51258,1,87340,87340,315800,228460,228460,8891,0,0,0
316210,application_1506638472019_31066,1,31155,31155,316210,285055,285055,11820,0,0,0
316330,application_1506638472019_38708,1,36661,36661,316330,279669,279669,11301,0,0,0
316360,application_1506638472019_29856,1,30603,30603,316360,285757,285757,12639,0,0,0
316390,application_1506638472019_15711,1,22527,22527,316390,293863,293863,11114,0,0,0
316590,application_1508364558011_31755,1,68154,68154,316590,248436,248436,9975,0,0,0
316860,application_1508364558011_50851,1,87267,87267,316860,229593,229593,9162,0,0,0
317010,application_1506638472019_24426,1,27661,27661,317010,289349,289349,12404,0,0,0
317300,application_1508364558011_40808,1,74447,74447,317300,242853,242853,9841,0,0,0
317620,application_1508364558011_41912,1,75509,75509,317620,242111,242111,9526,0,0,0
318130,application_1506638472019_31292,1,31440,31440,318130,286690,286690,12700,0,0,0
318400,application_1506638472019_25285,1,27815,27815,318400,290585,290585,11000,0,0,0
318430,application_1506638472019_24585,1,27708,27708,318430,290722,290722,11384,0,0,0
318460,application_1506638472019_8140,1,17292,17292,318460,301168,301168,13660,0,0,0
318720,application_1506638472019_25982,1,28006,28006,318720,290714,290714,11671,0,0,0
319150,application_1506638472019_25234,1,27806,27806,319150,291344,291344,10381,0,0,0
319150,application_1508364558011_50801,1,87261,87261,319150,231889,231889,9468,0,0,0
319530,application_1508364558011_12965,1,43927,43927,319530,275603,275603,11282,0,0,0
319570,application_1506638472019_23640,1,27251,27251,319570,292319,292319,11138,0,0,0
319900,application_1511916184019_0477,1,97599,97599,319900,222301,222301,8965,0,0,0
320020,application_1506638472019_31068,1,31155,31155,320020,288865,288865,13461,0,0,0
320160,application_1508364558011_50643,1,87243,87243,320160,232917,232917,9432,0,0,0
320210,application_1508364558011_50618,1,87237,87237,320210,232973,232973,9141,0,0,0
320700,application_1506638472019_32756,1,33435,33435,320700,287265,287265,10747,0,0,0
320790,application_1506638472019_29661,1,30089,30089,320790,290701,290701,13066,0,0,0
320960,application_1508364558011_39484,1,73666,73666,320960,247294,247294,10045,0,0,0
321420,application_1506638472019_15497,1,22484,22484,321420,298936,298936,11071,0,0,0
321550,application_1508364558011_50858,1,87268,87268,321550,234282,234282,9145,0,0,0
321790,application_1506638472019_26094,1,28040,28040,321790,293750,293750,11417,0,0,0
321830,application_1508364558011_52062,1,88074,88074,321830,233756,233756,9393,0,0,0
322170,application_1508364558011_47632,1,80918,80918,322170,241252,241252,10502,0,0,0
322990,application_1506638472019_24008,1,27322,27322,322990,295668,295668,12488,0,0,0
323240,application_1506638472019_29637,1,30088,30088,323240,293152,293152,12715,0,0,0
323550,application_1508364558011_45947,1,78957,78957,323550,244593,244593,10772,0,0,0
323620,application_1506638472019_24007,1,27322,27322,323620,296298,296298,11831,0,0,0
323930,application_1506638472019_35580,1,34956,34956,323930,288974,288974,12178,0,0,0
324130,application_1506638472019_31695,1,31902,31902,324130,292228,292228,11846,0,0,0
324230,application_1506638472019_35392,1,34929,34929,324230,289301,289301,11336,0,0,0
324290,application_1508364558011_25949,1,58074,58074,324290,266216,266216,10572,0,0,0
324360,application_1511528684064_2737,1,96363,96363,324360,227997,227997,9882,0,0,0
324730,application_1506638472019_0230,4,8987,8987,324730,315743,315743,13175,0,0,0
324750,application_1506638472019_31780,1,31997,31997,324750,292753,292753,11438,0,0,0
324860,application_1506638472019_9783,8,17695,17695,324860,307165,307165,12200,0,0,0
324970,application_1504131676014_25187,1,8317,8317,324970,316653,316653,16472,0,0,0
325000,application_1511916184019_2286,1,101140,101140,325000,223860,223860,9202,0,0,0
325080,application_1506638472019_26219,1,28076,28076,325080,297004,297004,11306,0,0,0
325410,application_1506638472019_15682,1,22521,22521,325410,302889,302889,12198,0,0,0
326650,application_1508364558011_26229,1,58612,58612,326650,268038,268038,11295,0,0,0
326690,application_1511916184019_2507,8,101754,101754,326690,224936,224936,10335,0,0,0
326710,application_1506638472019_15695,1,22524,22524,326710,304186,304186,11431,0,0,0
327120,application_1508364558011_0912,1,37989,37989,327120,289131,289131,11091,0,0,0
327220,application_1506638472019_26165,1,28059,28059,327220,299161,299161,11369,0,0,0
327350,application_1506638472019_36362,1,35202,35202,327350,292148,292148,12829,0,0,0
327440,application_1508364558011_27584,8,60984,60984,327440,266456,266456,9127,0,0,0
328050,application_1511916184019_1011,1,98562,98562,328050,229488,229488,9732,0,0,0
328430,application_1508364558011_0871,1,37987,37987,328430,290443,290443,11260,0,0,0
328450,application_1506638472019_31084,1,31158,31158,328450,297292,297292,12510,0,0,0
329350,application_1506638472019_34567,1,34616,34616,329350,294734,294734,13018,0,0,0
329790,application_1504131676014_24541,1,6905,6905,329790,322885,322885,17866,0,0,0
330010,application_1506638472019_29543,1,30083,30083,330010,299927,299927,13106,0,0,0
330490,application_1511916184019_0294,1,96942,96942,330490,233548,233548,9670,0,0,0
330980,application_1506638472019_36402,1,35210,35210,330980,295770,295770,11866,0,0,0
331240,application_1506638472019_29550,1,30083,30083,331240,301157,301157,15478,0,0,0
332200,application_1508364558011_28512,1,64302,64302,332200,267898,267898,11147,0,0,0
332940,application_1506638472019_29502,1,30080,30080,332940,302860,302860,11761,0,0,0
334580,application_1508364558011_48797,1,84848,84848,334580,249732,249732,11336,0,0,0
334720,application_1508364558011_7904,1,41592,41592,334720,293128,293128,11901,0,0,0
334740,application_1506638472019_25780,1,27930,27930,334740,306810,306810,12921,0,0,0
335250,application_1506638472019_35481,1,34943,34943,335250,300307,300307,11988,0,0,0
335350,application_1506638472019_26230,1,28084,28084,335350,307266,307266,12570,0,0,0
335380,application_1506638472019_35896,1,35045,35045,335380,300335,300335,12127,0,0,0
335610,application_1512440382012_0457,4,105890,105890,335610,229720,229720,9093,0,0,0
336400,application_1506638472019_35991,1,35061,35061,336400,301339,301339,12427,0,0,0
336520,application_1506638472019_36168,1,35140,35140,336520,301380,301380,12323,0,0,0
337190,application_1506638472019_36373,1,35204,35204,337190,301986,301986,11696,0,0,0
337190,application_1506638472019_36871,1,35487,35487,337190,301703,301703,12709,0,0,0
337290,application_1508364558011_27709,4,61461,61461,337290,275829,275829,9181,0,0,0
337470,application_1508364558011_26228,1,58612,58612,337470,278858,278858,11119,0,0,0
337840,application_1506638472019_8148,1,17293,17293,337840,320547,320547,13614,0,0,0
337960,application_1506638472019_31275,1,31427,31427,337960,306533,306533,13057,0,0,0
338400,application_1506638472019_36756,1,35369,35369,338400,303031,303031,12678,0,0,0
338620,application_1508364558011_36754,16,71305,71305,338620,267315,267315,23652,0,0,0
339110,application_1508364558011_42901,1,76836,76836,339110,262274,262274,11151,0,0,0
339330,application_1506638472019_29569,1,30084,30084,339330,309246,309246,12822,0,0,0
339500,application_1511916184019_3738,1,105034,105034,339500,234466,234466,11603,0,0,0
340380,application_1508364558011_29169,1,65335,65335,340380,275045,275045,11469,0,0,0
340490,application_1506638472019_15602,1,22504,22504,340490,317986,317986,13876,0,0,0
340600,application_1506638472019_29644,1,30088,30088,340600,310512,310512,12731,0,0,0
340740,application_1506638472019_35461,1,34940,34940,340740,305800,305800,12600,0,0,0
340810,application_1506638472019_24386,1,27614,27614,340810,313196,313196,12952,0,0,0
340830,application_1511916184019_1935,1,100286,100286,340830,240544,240544,11508,0,0,0
340880,application_1508364558011_27571,8,60928,60928,340880,279952,279952,8801,0,0,0
341340,application_1506638472019_29867,1,30604,30604,341340,310736,310736,12327,0,0,0
341420,application_1506638472019_34603,1,34622,34622,341420,306798,306798,13068,0,0,0
341910,application_1511916184019_0620,1,97880,97880,341910,244030,244030,10887,0,0,0
342200,application_1506638472019_35644,1,34969,34969,342200,307231,307231,12376,0,0,0
342280,application_1508364558011_43507,1,77850,77850,342280,264430,264430,11232,0,0,0
342430,application_1508364558011_37981,8,73045,73045,342430,269385,269385,11126,0,0,0
342670,application_1508364558011_48798,1,84848,84848,342670,257822,257822,12558,0,0,0
342780,application_1506638472019_36411,1,35212,35212,342780,307568,307568,12758,0,0,0
343650,application_1508364558011_48500,1,84569,84569,343650,259081,259081,11315,0,0,0
343840,application_1506638472019_29453,1,30077,30077,343840,313763,313763,13013,0,0,0
344460,application_1506638472019_29655,1,30088,30088,344460,314372,314372,12885,0,0,0
344710,application_1512440382012_1992,1,108438,108438,344710,236272,236272,10170,0,0,0
344760,application_1506638472019_36623,1,35341,35341,344760,309419,309419,12640,0,0,0
344880,application_1508364558011_37980,8,73045,73045,344880,271835,271835,10485,0,0,0
344910,application_1508364558011_33499,1,69497,69497,344910,275413,275413,11728,0,0,0
345370,application_1506638472019_34532,1,34604,34604,345370,310766,310766,13007,0,0,0
345420,application_1506638472019_26319,1,28326,28326,345420,317094,317094,13008,0,0,0
345990,application_1506638472019_33894,1,34393,34393,345990,311597,311597,13296,0,0,0
346020,application_1508364558011_36721,4,71193,71193,346020,274827,274827,10896,0,0,0
347570,application_1506638472019_25705,1,27884,27884,347570,319686,319686,13310,0,0,0
347610,application_1506638472019_22064,1,26430,26430,347610,321180,321180,12821,0,0,0
347920,application_1508364558011_47256,4,80455,80455,347920,267465,267465,9670,0,0,0
348440,application_1506638472019_29520,1,30081,30081,348440,318359,318359,12563,0,0,0
348920,application_1506638472019_36368,1,35203,35203,348920,313717,313717,12544,0,0,0
349180,application_1506638472019_29551,1,30083,30083,349180,319097,319097,12840,0,0,0
349250,application_1508364558011_19085,1,48371,48371,349250,300879,300879,11838,0,0,0
349480,application_1506638472019_22077,1,26448,26448,349480,323032,323032,13389,0,0,0
350130,application_1513025660013_0278,1,115348,115348,350130,234782,234782,11662,0,0,0
350460,application_1506638472019_27652,1,28841,28841,350460,321619,321619,13123,0,0,0
350500,application_1506638472019_29560,1,30084,30084,350500,320416,320416,12680,0,0,0
350550,application_1506638472019_36076,1,35121,35121,350550,315429,315429,12618,0,0,0
350660,application_1506638472019_36201,1,35144,35144,350660,315516,315516,14031,0,0,0
351600,application_1511528684064_1501,1,95628,95628,351600,255972,255972,12141,0,0,0
351630,application_1508364558011_31846,1,68291,68291,351630,283339,283339,12158,0,0,0
351680,application_1506638472019_36890,1,35491,35491,351680,316189,316189,12537,0,0,0
352250,application_1506638472019_36100,1,35126,35126,352250,317124,317124,13212,0,0,0
352310,application_1506638472019_36423,1,35215,35215,352310,317095,317095,12840,0,0,0
352530,application_1508364558011_32662,4,68860,68860,352530,283670,283670,13684,0,0,0
352540,application_1508364558011_40246,1,73852,73852,352540,278688,278688,12176,0,0,0
353090,application_1506638472019_29516,1,30081,30081,353090,323009,323009,13164,0,0,0
353960,application_1506638472019_29583,1,30085,30085,353960,323875,323875,13347,0,0,0
354100,application_1508364558011_47088,1,80200,80200,354100,273900,273900,12091,0,0,0
354220,application_1506638472019_24705,1,27732,27732,354220,326488,326488,13206,0,0,0
354670,application_1506638472019_29654,1,30088,30088,354670,324582,324582,15966,0,0,0
354700,application_1508364558011_32478,1,68644,68644,354700,286056,286056,14441,0,0,0
354870,application_1506638472019_33911,1,34395,34395,354870,320475,320475,13611,0,0,0
354930,application_1506638472019_23999,1,27320,27320,354930,327610,327610,13688,0,0,0
356200,application_1508364558011_32788,8,69042,69042,356200,287158,287158,11485,0,0,0
357180,application_1506638472019_20758,8,26092,26092,357180,331088,331088,13133,0,0,0
357220,application_1506638472019_35737,1,34987,34987,357220,322233,322233,13274,0,0,0
357480,application_1506638472019_38110,4,36184,36184,357480,321296,321296,12473,0,0,0
358200,application_1508364558011_41574,1,75106,75106,358200,283094,283094,12684,0,0,0
358320,application_1506638472019_36937,1,35502,35502,358320,322818,322818,15307,0,0,0
359230,application_1508364558011_36999,1,71933,71933,359230,287297,287297,13123,0,0,0
359630,application_1506638472019_33929,1,34397,34397,359630,325233,325233,13855,0,0,0
360500,application_1506638472019_32312,8,33274,33274,360500,327226,327226,11653,0,0,0
361740,application_1508364558011_32224,1,68551,68551,361740,293189,293189,13472,0,0,0
362430,application_1506638472019_36637,1,35345,35345,362430,327085,327085,13544,0,0,0
362670,application_1506638472019_36876,1,35488,35488,362670,327182,327182,13667,0,0,0
362760,application_1506638472019_22075,1,26447,26447,362760,336313,336313,14629,0,0,0
362770,application_1506638472019_33917,1,34396,34396,362770,328374,328374,13714,0,0,0
362860,application_1506638472019_31774,1,31996,31996,362860,330864,330864,13723,0,0,0
362880,application_1512440382012_4121,1,109882,109882,362880,252998,252998,12471,0,0,0
363080,application_1508364558011_36513,8,70818,70818,363080,292262,292262,11398,0,0,0
363370,application_1508364558011_52858,1,89381,89381,363370,273989,273989,12791,0,0,0
363420,application_1506638472019_33908,1,34395,34395,363420,329025,329025,13655,0,0,0
363860,application_1506638472019_29459,1,30077,30077,363860,333783,333783,13040,0,0,0
364650,application_1508364558011_30903,1,67277,67277,364650,297373,297373,13037,0,0,0
364950,application_1506638472019_7825,1,17263,17263,364950,347687,347687,15690,0,0,0
365430,application_1508364558011_25801,4,57872,57872,365430,307558,307558,11687,0,0,0
365600,application_1508364558011_47154,1,80252,80252,365600,285348,285348,15598,0,0,0
365670,application_1506638472019_31073,1,31156,31156,365670,334514,334514,14741,0,0,0
366280,application_1511916184019_1620,1,99718,99718,366280,266562,266562,12998,0,0,0
367070,application_1506638472019_29822,1,30509,30509,367070,336561,336561,16939,0,0,0
367140,application_1506638472019_36897,1,35492,35492,367140,331648,331648,14458,0,0,0
367180,application_1508364558011_31492,16,67658,67658,367180,299522,299522,29737,0,0,0
367310,application_1508364558011_48472,1,84567,84567,367310,282743,282743,13046,0,0,0
368390,application_1506638472019_35915,1,35048,35048,368390,333342,333342,14712,0,0,0
369480,application_1506638472019_36698,1,35357,35357,369480,334123,334123,14160,0,0,0
369560,application_1506638472019_15002,1,21982,21982,369560,347578,347578,14904,0,0,0
369710,application_1506638472019_29623,1,30087,30087,369710,339623,339623,15000,0,0,0
370360,application_1506638472019_25887,1,27955,27955,370360,342405,342405,14201,0,0,0
370740,application_1511916184019_2970,4,103812,103812,370740,266928,266928,10601,0,0,0
370790,application_1506638472019_29526,1,30082,30082,370790,340708,340708,15256,0,0,0
371830,application_1506638472019_37568,1,35962,35962,371830,335868,335868,14981,0,0,0
372870,application_1506638472019_26068,1,28033,28033,372870,344837,344837,14813,0,0,0
373200,application_1512440382012_1485,8,107735,107735,373200,265465,265465,11657,0,0,0
373360,application_1508364558011_42807,1,76707,76707,373360,296653,296653,14846,0,0,0
373690,application_1508364558011_4965,4,39855,39855,373690,333835,333835,13576,0,0,0
373820,application_1512440382012_5579,1,111018,111018,373820,262802,262802,12453,0,0,0
374310,application_1508364558011_48505,1,84570,84570,374310,289740,289740,15401,0,0,0
376190,application_1506638472019_29523,1,30081,30081,376190,346109,346109,14736,0,0,0
376320,application_1508364558011_22259,2,53325,53325,376320,322995,322995,20999,0,0,0
376380,application_1506638472019_24013,1,27323,27323,376380,349057,349057,15315,0,0,0
376610,application_1508364558011_19114,1,48374,48374,376610,328236,328236,15052,0,0,0
377240,application_1506638472019_24094,1,27341,27341,377240,349899,349899,15364,0,0,0
377470,application_1506638472019_21121,1,26200,26200,377470,351270,351270,15919,0,0,0
377490,application_1512440382012_6684,1,114844,114844,377490,262646,262646,13233,0,0,0
380250,application_1506638472019_37620,1,35965,35965,380250,344285,344285,14526,0,0,0
380580,application_1508364558011_52959,1,89572,89572,380580,291008,291008,14666,0,0,0
381030,application_1512440382012_6143,1,113776,113776,381030,267254,267254,14194,0,0,0
382320,application_1506638472019_29647,1,30088,30088,382320,352232,352232,15858,0,0,0
382330,application_1512440382012_5003,1,110333,110333,382330,271997,271997,13253,0,0,0
382560,application_1506638472019_29641,1,30088,30088,382560,352472,352472,16068,0,0,0
383600,application_1513627406021_0150,2,118157,118157,383600,265443,265443,18318,0,0,0
383950,application_1508364558011_32463,1,68643,68643,383950,315307,315307,14392,0,0,0
384590,application_1508364558011_28571,4,64415,64415,384590,320175,320175,13360,0,0,0
384650,application_1506638472019_29556,1,30083,30083,384650,354567,354567,15811,0,0,0
385080,application_1508364558011_19104,1,48373,48373,385080,336707,336707,15128,0,0,0
385440,application_1506638472019_23632,1,27250,27250,385440,358190,358190,15768,0,0,0
386940,application_1508364558011_26957,4,59700,59700,386940,327240,327240,13415,0,0,0
387220,application_1508364558011_29468,8,66039,66039,387220,321181,321181,13797,0,0,0
387320,application_1508364558011_29674,4,66155,66155,387320,321165,321165,14393,0,0,0
387390,application_1506638472019_29574,1,30084,30084,387390,357306,357306,16065,0,0,0
388350,application_1512440382012_6572,1,114527,114527,388350,273823,273823,14011,0,0,0
388680,application_1512440382012_2222,1,108735,108735,388680,279945,279945,14425,0,0,0
388770,application_1508364558011_1432,1,38638,38638,388770,350132,350132,16174,0,0,0
388800,application_1512440382012_4974,8,110226,110226,388800,278574,278574,15498,0,0,0
388860,application_1508364558011_32479,1,68644,68644,388860,320216,320216,14615,0,0,0
389130,application_1506638472019_29519,1,30081,30081,389130,359049,359049,15936,0,0,0
389280,application_1506638472019_25725,4,27893,27893,389280,361387,361387,14582,0,0,0
389610,application_1508364558011_32448,1,68641,68641,389610,320969,320969,15654,0,0,0
389810,application_1508364558011_42808,1,76707,76707,389810,313103,313103,15202,0,0,0
389880,application_1508364558011_38763,8,73572,73572,389880,316308,316308,13254,0,0,0
389930,application_1508364558011_52854,1,89381,89381,389930,300549,300549,13879,0,0,0
389960,application_1512440382012_2209,1,108733,108733,389960,281227,281227,15066,0,0,0
390790,application_1508364558011_26956,4,59700,59700,390790,331090,331090,13173,0,0,0
390870,application_1506638472019_23132,1,27161,27161,390870,363709,363709,16464,0,0,0
391010,application_1506638472019_29620,1,30087,30087,391010,360923,360923,16048,0,0,0
391260,application_1506638472019_36796,1,35379,35379,391260,355881,355881,16206,0,0,0
391790,application_1512440382012_1261,1,107166,107166,391790,284624,284624,14352,0,0,0
392970,application_1508364558011_49140,8,85195,85195,392970,307775,307775,11986,0,0,0
393550,application_1513025660013_1022,1,116753,116753,393550,276797,276797,14561,0,0,0
394270,application_1506638472019_31375,1,31445,31445,394270,362825,362825,16525,0,0,0
394920,application_1508364558011_16420,1,46515,46515,394920,348405,348405,16331,0,0,0
395500,application_1513025660013_0774,1,116272,116272,395500,279228,279228,14700,0,0,0
395530,application_1508364558011_52381,1,88290,88290,395530,307240,307240,14340,0,0,0
395650,application_1506638472019_32797,8,33452,33452,395650,362198,362198,14680,0,0,0
395750,application_1508364558011_46539,1,79487,79487,395750,316263,316263,14443,0,0,0
396730,application_1508364558011_11622,4,43301,43301,396730,353429,353429,14535,0,0,0
396810,application_1506638472019_5812,1,15929,15929,396810,380881,380881,18570,0,0,0
397340,application_1506638472019_24014,1,27324,27324,397340,370016,370016,16745,0,0,0
400060,application_1508364558011_25334,8,57467,57467,400060,342593,342593,14977,0,0,0
400550,application_1506638472019_29651,1,30088,30088,400550,370462,370462,16193,0,0,0
401410,application_1506638472019_18827,4,24752,24752,401410,376658,376658,16346,0,0,0
401630,application_1506638472019_0264,8,9074,9074,401630,392556,392556,22537,0,0,0
403550,application_1508364558011_43341,4,77619,77619,403550,325931,325931,12842,0,0,0
403820,application_1506638472019_36404,1,35210,35210,403820,368610,368610,16916,0,0,0
404080,application_1508364558011_41485,1,74963,74963,404080,329117,329117,17560,0,0,0
405790,application_1508364558011_32472,1,68643,68643,405790,337147,337147,15372,0,0,0
405900,application_1513025660013_0440,2,115606,115606,405900,290294,290294,20154,0,0,0
406550,application_1508364558011_0692,1,37804,37804,406550,368746,368746,17946,0,0,0
409040,application_1508364558011_0714,1,37804,37804,409040,371236,371236,17174,0,0,0
409690,application_1506638472019_36224,1,35146,35146,409690,374544,374544,16905,0,0,0
410140,application_1506638472019_29428,1,30075,30075,410140,380065,380065,16790,0,0,0
410350,application_1508364558011_47152,1,80252,80252,410350,330098,330098,15685,0,0,0
410440,application_1506638472019_29395,4,30027,30027,410440,380413,380413,14416,0,0,0
410550,application_1508364558011_33489,1,69496,69496,410550,341054,341054,16167,0,0,0
411290,application_1504131676014_10328,1,0,0,411290,411290,411290,28181,0,0,0
411670,application_1508364558011_13284,1,44272,44272,411670,367398,367398,17213,0,0,0
412010,application_1508364558011_27439,4,60462,60462,412010,351548,351548,14345,0,0,0
413000,application_1508364558011_2611,1,39030,39030,413000,373970,373970,17646,0,0,0
413210,application_1506638472019_36901,1,35493,35493,413210,377717,377717,17916,0,0,0
414520,application_1508364558011_52677,8,88874,88874,414520,325646,325646,15282,0,0,0
414580,application_1508364558011_41963,4,75592,75592,414580,338988,338988,14065,0,0,0
415040,application_1506638472019_29424,1,30075,30075,415040,384965,384965,17662,0,0,0
415480,application_1508364558011_0688,1,37803,37803,415480,377677,377677,17753,0,0,0
415620,application_1508364558011_35889,4,70161,70161,415620,345459,345459,15304,0,0,0
416290,application_1506638472019_23646,1,27252,27252,416290,389038,389038,17911,0,0,0
417430,application_1512440382012_2206,1,108733,108733,417430,308697,308697,16130,0,0,0
418140,application_1506638472019_23560,8,27240,27240,418140,390900,390900,17362,0,0,0
418150,application_1512440382012_2402,1,108942,108942,418150,309208,309208,15721,0,0,0
418640,application_1508364558011_0686,1,37803,37803,418640,380837,380837,17777,0,0,0
418900,application_1513025660013_0882,1,116443,116443,418900,302457,302457,16735,0,0,0
419150,application_1508364558011_47837,8,81740,81740,419150,337410,337410,17907,0,0,0
419670,application_1508364558011_29654,4,66127,66127,419670,353543,353543,15295,0,0,0
419890,application_1512440382012_1481,1,107715,107715,419890,312175,312175,16562,0,0,0
420230,application_1506638472019_36896,1,35492,35492,420230,384738,384738,18317,0,0,0
420370,application_1508364558011_32429,1,68640,68640,420370,351730,351730,17842,0,0,0
420890,application_1513025660013_1014,1,116753,116753,420890,304137,304137,16663,0,0,0
421160,application_1506638472019_28826,1,29283,29283,421160,391877,391877,18150,0,0,0
421510,application_1506638472019_0280,8,9107,9107,421510,412403,412403,22254,0,0,0
422250,application_1508364558011_34848,8,69845,69845,422250,352405,352405,14814,0,0,0
422500,application_1506638472019_0261,1,9061,9061,422500,413439,413439,22173,0,0,0
423080,application_1504131676014_24843,1,7297,7297,423080,415783,415783,23819,0,0,0
423910,application_1508364558011_30323,2,66689,66689,423910,357221,357221,24204,0,0,0
425900,application_1512440382012_1480,1,107711,107711,425900,318189,318189,16724,0,0,0
426580,application_1506638472019_37615,1,35964,35964,426580,390616,390616,18508,0,0,0
427310,application_1508364558011_0694,1,37804,37804,427310,389506,389506,18015,0,0,0
427610,application_1506638472019_17609,4,24280,24280,427610,403330,403330,16810,0,0,0
428990,application_1513627406021_0690,1,119088,119088,428990,309902,309902,16628,0,0,0
429210,application_1508364558011_25837,4,57899,57899,429210,371311,371311,13751,0,0,0
429880,application_1504131676014_24849,4,7322,7322,429880,422558,422558,20294,0,0,0
431540,application_1508364558011_22756,4,54529,54529,431540,377011,377011,15460,0,0,0
432030,application_1506638472019_26375,1,28351,28351,432030,403679,403679,19733,0,0,0
433280,application_1506638472019_32739,1,33435,33435,433280,399845,399845,19754,0,0,0
434410,application_1511528684064_0150,4,90817,90817,434410,343593,343593,17382,0,0,0
435440,application_1506638472019_33870,1,34387,34387,435440,401053,401053,19752,0,0,0
436600,application_1513627406021_2494,1,122471,122471,436600,314129,314129,17116,0,0,0
437130,application_1508364558011_27817,4,61837,61837,437130,375293,375293,19462,0,0,0
437260,application_1506638472019_32713,1,33433,33433,437260,403827,403827,20133,0,0,0
437990,application_1511916184019_0697,1,98014,98014,437990,339976,339976,20050,0,0,0
439940,application_1506638472019_29501,1,30080,30080,439940,409860,409860,20417,0,0,0
440450,application_1506638472019_29421,1,30075,30075,440450,410375,410375,20649,0,0,0
440980,application_1504131676014_24892,1,7360,7360,440980,433620,433620,25686,0,0,0
441920,application_1508364558011_32451,1,68642,68642,441920,373278,373278,19087,0,0,0
443750,application_1512440382012_2529,1,109185,109185,443750,334565,334565,18633,0,0,0
444070,application_1506638472019_32730,1,33434,33434,444070,410636,410636,20520,0,0,0
444110,application_1508364558011_24209,4,56418,56418,444110,387692,387692,16372,0,0,0
445110,application_1511916184019_0784,1,98142,98142,445110,346968,346968,19363,0,0,0
445540,application_1506638472019_8037,1,17284,17284,445540,428256,428256,20230,0,0,0
446470,application_1508364558011_3991,1,39308,39308,446470,407162,407162,20379,0,0,0
446580,application_1508364558011_14974,1,45538,45538,446580,401042,401042,20857,0,0,0
447070,application_1508364558011_32462,1,68643,68643,447070,378427,378427,19357,0,0,0
447290,application_1511916184019_0188,1,96780,96780,447290,350510,350510,18940,0,0,0
447530,application_1506638472019_38518,1,36292,36292,447530,411238,411238,20755,0,0,0
447570,application_1513627406021_0469,1,118495,118495,447570,329075,329075,19081,0,0,0
448580,application_1504131676014_21369,1,4328,4328,448580,444252,444252,27957,0,0,0
449310,application_1512440382012_1651,1,108088,108088,449310,341222,341222,18080,0,0,0
451250,application_1506638472019_20178,4,25413,25413,451250,425837,425837,24599,0,0,0
451770,application_1506638472019_14890,1,21961,21961,451770,429809,429809,21747,0,0,0
451790,application_1508364558011_29094,1,65307,65307,451790,386483,386483,22026,0,0,0
453500,application_1513627406021_1673,1,121154,121154,453500,332346,332346,19191,0,0,0
453750,application_1506638472019_29553,1,30083,30083,453750,423667,423667,21615,0,0,0
454570,application_1506638472019_13531,1,19875,19875,454570,434695,434695,21993,0,0,0
455600,application_1508364558011_52026,1,88004,88004,455600,367596,367596,21879,0,0,0
456460,application_1508364558011_42521,1,76556,76556,456460,379904,379904,20090,0,0,0
456680,application_1508364558011_30951,1,67306,67306,456680,389374,389374,21585,0,0,0
456730,application_1508364558011_46044,1,79073,79073,456730,377657,377657,19341,0,0,0
456810,application_1511916184019_0831,1,98246,98246,456810,358564,358564,19748,0,0,0
457190,application_1506638472019_14919,1,21967,21967,457190,435223,435223,21507,0,0,0
457570,application_1508364558011_48405,8,84529,84529,457570,373041,373041,22232,0,0,0
460840,application_1506638472019_32612,1,33361,33361,460840,427479,427479,21539,0,0,0
461590,application_1506638472019_37188,1,35693,35693,461590,425897,425897,21399,0,0,0
464330,application_1511528684064_1155,2,94863,94863,464330,369467,369467,25595,0,0,0
465480,application_1508364558011_30955,1,67307,67307,465480,398173,398173,20722,0,0,0
465630,application_1504131676014_20459,8,3010,3010,465630,462620,462620,31330,0,0,0
466280,application_1506638472019_14907,1,21964,21964,466280,444316,444316,22093,0,0,0
467540,application_1513627406021_0961,1,119660,119660,467540,347880,347880,20825,0,0,0
467870,application_1506638472019_17589,1,24230,24230,467870,443640,443640,23161,0,0,0
468010,application_1508364558011_31263,8,67371,67371,468010,400639,400639,21645,0,0,0
468320,application_1508364558011_36609,1,70953,70953,468320,397367,397367,21285,0,0,0
469450,application_1508364558011_28445,1,64035,64035,469450,405415,405415,23649,0,0,0
469940,application_1508364558011_44749,2,78181,78181,469940,391759,391759,27885,0,0,0
470240,application_1513627406021_0116,1,118106,118106,470240,352134,352134,20815,0,0,0
470850,application_1508364558011_46538,1,79487,79487,470850,391363,391363,21831,0,0,0
472450,application_1508364558011_26206,4,58599,58599,472450,413851,413851,19215,0,0,0
474410,application_1506638472019_15414,1,22305,22305,474410,452105,452105,23615,0,0,0
475940,application_1508364558011_40559,8,73933,73933,475940,402007,402007,22935,0,0,0
476000,application_1508364558011_51902,8,87836,87836,476000,388164,388164,21886,0,0,0
476030,application_1508364558011_17694,1,47687,47687,476030,428343,428343,22188,0,0,0
476470,application_1506638472019_15290,1,22280,22280,476470,454190,454190,23376,0,0,0
476970,application_1508364558011_26112,4,58483,58483,476970,418487,418487,20360,0,0,0
477240,application_1508364558011_31444,4,67633,67633,477240,409607,409607,17538,0,0,0
477270,application_1511916184019_0291,2,96939,96939,477270,380331,380331,26849,0,0,0
477320,application_1506638472019_37094,1,35540,35540,477320,441780,441780,23150,0,0,0
477610,application_1511528684064_2014,1,96093,96093,477610,381517,381517,22568,0,0,0
478850,application_1506638472019_4535,8,15604,15604,478850,463246,463246,31352,0,0,0
479400,application_1506638472019_5819,8,15941,15941,479400,463459,463459,24190,0,0,0
479580,application_1508364558011_28963,8,65158,65158,479580,414422,414422,21165,0,0,0
479750,application_1508364558011_37129,1,72133,72133,479750,407617,407617,23382,0,0,0
480710,application_1508364558011_25848,4,57914,57914,480710,422796,422796,27615,0,0,0
480970,application_1506638472019_29524,1,30082,30082,480970,450888,450888,23416,0,0,0
482060,application_1508364558011_21631,2,50858,50858,482060,431202,431202,39861,0,0,0
485010,application_1508364558011_31686,1,68015,68015,485010,416995,416995,21937,0,0,0
485290,application_1511528684064_1054,2,94695,94695,485290,390595,390595,27626,0,0,0
485930,application_1508364558011_22179,1,52983,52983,485930,432947,432947,23876,0,0,0
486360,application_1508364558011_26135,1,58520,58520,486360,427840,427840,23849,0,0,0
486450,application_1506638472019_31629,1,31704,31704,486450,454746,454746,23489,0,0,0
486890,application_1506638472019_22910,1,27004,27004,486890,459886,459886,24321,0,0,0
486890,application_1508364558011_16540,1,46586,46586,486890,440304,440304,23738,0,0,0
486990,application_1508364558011_47163,1,80262,80262,486990,406728,406728,22752,0,0,0
487080,application_1508364558011_47145,1,80251,80251,487080,406829,406829,21192,0,0,0
487480,application_1508364558011_16168,4,46393,46393,487480,441087,441087,20272,0,0,0
487590,application_1506638472019_29090,8,29534,29534,487590,458056,458056,24129,0,0,0
487950,application_1508364558011_27684,4,61387,61387,487950,426563,426563,22387,0,0,0
488570,application_1506638472019_20657,1,25881,25881,488570,462689,462689,24702,0,0,0
488660,application_1508364558011_6037,1,40272,40272,488660,448388,448388,23910,0,0,0
488750,application_1508364558011_0732,1,37805,37805,488750,450945,450945,24322,0,0,0
489540,application_1506638472019_31630,1,31704,31704,489540,457836,457836,23660,0,0,0
489920,application_1508364558011_0741,1,37805,37805,489920,452115,452115,24422,0,0,0
490170,application_1508364558011_0733,1,37805,37805,490170,452365,452365,24309,0,0,0
492370,application_1508364558011_27965,4,62350,62350,492370,430020,430020,20150,0,0,0
492460,application_1511528684064_0455,8,92469,92469,492460,399991,399991,23683,0,0,0
492910,application_1508364558011_24540,1,57202,57202,492910,435708,435708,24480,0,0,0
493010,application_1506638472019_7532,1,17227,17227,493010,475783,475783,25691,0,0,0
495030,application_1512440382012_0771,1,106379,106379,495030,388651,388651,23098,0,0,0
495250,application_1508364558011_0737,1,37805,37805,495250,457445,457445,24338,0,0,0
495450,application_1508364558011_52800,1,89293,89293,495450,406157,406157,24693,0,0,0
495890,application_1508364558011_30363,1,66763,66763,495890,429127,429127,23817,0,0,0
495990,application_1511916184019_1290,1,99245,99245,495990,396745,396745,23855,0,0,0
496340,application_1508364558011_51991,8,87964,87964,496340,408376,408376,22902,0,0,0
496430,application_1508364558011_1380,8,38534,38534,496430,457896,457896,27144,0,0,0
497110,application_1508364558011_5328,1,39870,39870,497110,457240,457240,25091,0,0,0
497230,application_1511528684064_1380,1,95267,95267,497230,401963,401963,24028,0,0,0
498220,application_1511528684064_0458,8,92469,92469,498220,405751,405751,23605,0,0,0
498290,application_1511916184019_0023,1,96494,96494,498290,401796,401796,24403,0,0,0
498300,application_1508364558011_30334,1,66714,66714,498300,431586,431586,24232,0,0,0
498370,application_1511916184019_1422,1,99523,99523,498370,398847,398847,23869,0,0,0
499060,application_1508364558011_47971,1,82583,82583,499060,416477,416477,24719,0,0,0
499590,application_1508364558011_48720,1,84727,84727,499590,414863,414863,25813,0,0,0
500030,application_1511916184019_0364,2,97173,97173,500030,402857,402857,29809,0,0,0
500170,application_1512440382012_3700,8,109762,109762,500170,390408,390408,23606,0,0,0
500360,application_1511528684064_0380,1,91974,91974,500360,408386,408386,23747,0,0,0
500470,application_1508364558011_41998,1,75655,75655,500470,424815,424815,24753,0,0,0
501370,application_1512440382012_0016,1,105241,105241,501370,396129,396129,23019,0,0,0
502000,application_1508364558011_47969,1,82572,82572,502000,419428,419428,24923,0,0,0
503050,application_1506638472019_17347,1,23590,23590,503050,479460,479460,26917,0,0,0
503640,application_1508364558011_20351,4,49573,49573,503640,454067,454067,21237,0,0,0
503670,application_1508364558011_33281,1,69384,69384,503670,434286,434286,24560,0,0,0
504280,application_1506638472019_28365,1,29148,29148,504280,475132,475132,26411,0,0,0
504390,application_1508364558011_0357,1,37534,37534,504390,466856,466856,26369,0,0,0
504840,application_1506638472019_1842,8,10634,10634,504840,494206,494206,29471,0,0,0
508430,application_1513627406021_0121,1,118108,118108,508430,390322,390322,24019,0,0,0
508750,application_1508364558011_5393,4,39922,39922,508750,468828,468828,24864,0,0,0
508980,application_1511528684064_0760,8,93896,93896,508980,415084,415084,29751,0,0,0
509420,application_1511528684064_0046,1,90300,90300,509420,419120,419120,25434,0,0,0
510430,application_1506638472019_22634,1,26907,26907,510430,483523,483523,27293,0,0,0
510870,application_1508364558011_40444,1,73905,73905,510870,436965,436965,25690,0,0,0
511570,application_1508364558011_31537,1,67735,67735,511570,443835,443835,25721,0,0,0
511870,application_1508364558011_46862,1,79840,79840,511870,432030,432030,24981,0,0,0
512070,application_1508364558011_27437,4,60462,60462,512070,451608,451608,25686,0,0,0
513720,application_1508364558011_33830,1,69692,69692,513720,444028,444028,26416,0,0,0
514010,application_1508364558011_18466,8,47960,47960,514010,466050,466050,25541,0,0,0
515150,application_1506638472019_20096,1,25149,25149,515150,490001,490001,26494,0,0,0
517130,application_1508364558011_50309,1,86924,86924,517130,430206,430206,25869,0,0,0
517130,application_1512440382012_1151,1,106947,106947,517130,410183,410183,25758,0,0,0
519300,application_1508364558011_25853,4,57920,57920,519300,461380,461380,23522,0,0,0
519620,application_1508364558011_31763,16,68170,68170,519620,451450,451450,49135,0,0,0
520360,application_1508364558011_6312,1,40608,40608,520360,479752,479752,27929,0,0,0
520680,application_1508364558011_0291,1,37434,37434,520680,483246,483246,27158,0,0,0
522800,application_1508364558011_29108,1,65309,65309,522800,457491,457491,28725,0,0,0
523680,application_1508364558011_46914,1,79923,79923,523680,443757,443757,26660,0,0,0
523700,application_1506638472019_13846,1,19907,19907,523700,503793,503793,29567,0,0,0
524640,application_1508364558011_50057,8,86578,86578,524640,438062,438062,26130,0,0,0
525060,application_1508364558011_31578,1,67812,67812,525060,457248,457248,27593,0,0,0
525300,application_1506638472019_2386,8,12381,12381,525300,512919,512919,31155,0,0,0
526550,application_1513025660013_0641,1,115965,115965,526550,410585,410585,26388,0,0,0
527120,application_1508364558011_12814,1,43745,43745,527120,483375,483375,27503,0,0,0
527300,application_1506638472019_35503,1,34945,34945,527300,492355,492355,28283,0,0,0
527440,application_1508364558011_24710,1,57339,57339,527440,470101,470101,29185,0,0,0
527510,application_1506638472019_29737,1,30213,30213,527510,497297,497297,27559,0,0,0
530490,application_1513025660013_0574,1,115801,115801,530490,414689,414689,27166,0,0,0
530760,application_1508364558011_50049,1,86563,86563,530760,444197,444197,28484,0,0,0
531240,application_1508364558011_31574,1,67808,67808,531240,463432,463432,28785,0,0,0
531320,application_1506638472019_2012,4,11427,11427,531320,519893,519893,36220,0,0,0
531800,application_1511528684064_0802,1,93998,93998,531800,437802,437802,26975,0,0,0
531900,application_1506638472019_29439,1,30076,30076,531900,501824,501824,29936,0,0,0
533820,application_1508364558011_29140,1,65315,65315,533820,468505,468505,28809,0,0,0
534700,application_1508364558011_46006,1,79064,79064,534700,455636,455636,29073,0,0,0
535210,application_1513025660013_0640,1,115965,115965,535210,419245,419245,26960,0,0,0
536560,application_1508364558011_31658,1,67975,67975,536560,468585,468585,28306,0,0,0
536690,application_1508364558011_31446,4,67633,67633,536690,469057,469057,26676,0,0,0
536750,application_1511916184019_1301,1,99256,99256,536750,437494,437494,28693,0,0,0
536810,application_1508364558011_27502,1,60717,60717,536810,476093,476093,27655,0,0,0
537060,application_1508364558011_25332,1,57466,57466,537060,479594,479594,28074,0,0,0
537550,application_1512440382012_2616,1,109327,109327,537550,428223,428223,27888,0,0,0
538210,application_1508364558011_50321,1,86929,86929,538210,451281,451281,28823,0,0,0
538940,application_1512440382012_0321,1,105585,105585,538940,433355,433355,27973,0,0,0
539710,application_1506638472019_32067,8,32933,32933,539710,506777,506777,33797,0,0,0
539780,application_1511528684064_0706,1,93748,93748,539780,446032,446032,28897,0,0,0
539930,application_1508364558011_29046,1,65299,65299,539930,474631,474631,28165,0,0,0
540000,application_1508364558011_24756,4,57360,57360,540000,482640,482640,24777,0,0,0
540430,application_1506638472019_34115,1,34422,34422,540430,506008,506008,30326,0,0,0
541160,application_1508364558011_29139,1,65314,65314,541160,475846,475846,29229,0,0,0
541440,application_1508364558011_13269,4,44230,44230,541440,497210,497210,28212,0,0,0
543490,application_1506638472019_38534,1,36293,36293,543490,507197,507197,29094,0,0,0
544650,application_1508364558011_22590,4,54311,54311,544650,490339,490339,25827,0,0,0
544740,application_1508364558011_36346,1,70610,70610,544740,474130,474130,29179,0,0,0
544960,application_1508364558011_52198,1,88181,88181,544960,456779,456779,28561,0,0,0
545730,application_1508364558011_29062,1,65302,65302,545730,480428,480428,29356,0,0,0
545840,application_1511916184019_1343,1,99383,99383,545840,446457,446457,29797,0,0,0
546670,application_1508364558011_2619,1,39030,39030,546670,507640,507640,31006,0,0,0
547000,application_1506638472019_38540,1,36294,36294,547000,510706,510706,30102,0,0,0
547030,application_1508364558011_40024,8,73792,73792,547030,473238,473238,30115,0,0,0
547060,application_1512440382012_5252,1,110537,110537,547060,436523,436523,28447,0,0,0
547220,application_1508364558011_25288,1,57448,57448,547220,489772,489772,29546,0,0,0
547530,application_1508364558011_23048,1,55417,55417,547530,492113,492113,29523,0,0,0
547780,application_1508364558011_42699,1,76693,76693,547780,471087,471087,30195,0,0,0
548190,application_1506638472019_32842,1,33516,33516,548190,514674,514674,31330,0,0,0
549890,application_1508364558011_52503,1,88481,88481,549890,461409,461409,28291,0,0,0
550360,application_1506638472019_12647,8,19291,19291,550360,531069,531069,30485,0,0,0
551060,application_1506638472019_26379,1,28351,28351,551060,522709,522709,31521,0,0,0
551210,application_1506638472019_12709,8,19558,19558,551210,531652,531652,31139,0,0,0
551310,application_1508364558011_50048,1,86563,86563,551310,464747,464747,29157,0,0,0
551600,application_1512440382012_1150,1,106947,106947,551600,444653,444653,31083,0,0,0
551700,application_1511528684064_0761,8,93896,93896,551700,457804,457804,30094,0,0,0
551840,application_1508364558011_17701,1,47706,47706,551840,504134,504134,30979,0,0,0
552270,application_1508364558011_34841,1,69820,69820,552270,482450,482450,29484,0,0,0
552290,application_1508364558011_32859,8,69132,69132,552290,483158,483158,28564,0,0,0
553440,application_1508364558011_29068,1,65303,65303,553440,488137,488137,30427,0,0,0
555340,application_1506638472019_29480,1,30079,30079,555340,525261,525261,31919,0,0,0
555500,application_1508364558011_50196,4,86775,86775,555500,468725,468725,26271,0,0,0
555510,application_1508364558011_23389,1,56061,56061,555510,499449,499449,30985,0,0,0
555710,application_1512440382012_2596,1,109306,109306,555710,446404,446404,29462,0,0,0
556340,application_1508364558011_29077,1,65304,65304,556340,491036,491036,30407,0,0,0
556690,application_1508364558011_29128,1,65313,65313,556690,491377,491377,30118,0,0,0
556840,application_1508364558011_2575,4,39025,39025,556840,517815,517815,26963,0,0,0
559210,application_1506638472019_0085,1,8681,8681,559210,550529,550529,37242,0,0,0
559220,application_1512440382012_1649,1,108088,108088,559220,451132,451132,29614,0,0,0
559500,application_1511528684064_0724,1,93784,93784,559500,465716,465716,31359,0,0,0
560090,application_1512440382012_0127,1,105302,105302,560090,454788,454788,30733,0,0,0
560450,application_1512440382012_2761,4,109558,109558,560450,450892,450892,25775,0,0,0
561130,application_1513627406021_0602,1,118792,118792,561130,442338,442338,31271,0,0,0
561160,application_1511528684064_0108,8,90636,90636,561160,470524,470524,31619,0,0,0
562780,application_1508364558011_47865,1,81889,81889,562780,480891,480891,30641,0,0,0
562930,application_1506638472019_6108,8,16598,16598,562930,546332,546332,36240,0,0,0
563790,application_1511916184019_1133,16,98937,98937,563790,464853,464853,54928,0,0,0
564180,application_1508364558011_23423,1,56063,56063,564180,508117,508117,31389,0,0,0
565580,application_1506638472019_5948,8,16160,16160,565580,549420,549420,35347,0,0,0
565850,application_1508364558011_28601,1,64463,64463,565850,501387,501387,31535,0,0,0
566070,application_1508364558011_23604,1,56071,56071,566070,509999,509999,32651,0,0,0
566730,application_1506638472019_14758,2,21631,21631,566730,545099,545099,51705,0,0,0
570370,application_1513025660013_0572,1,115801,115801,570370,454569,454569,30829,0,0,0
570980,application_1508364558011_9823,4,42138,42138,570980,528842,528842,30900,0,0,0
571270,application_1511916184019_1187,16,99050,99050,571270,472220,472220,55774,0,0,0
571460,application_1512440382012_1272,1,107174,107174,571460,464286,464286,32161,0,0,0
572540,application_1508364558011_22814,1,54626,54626,572540,517914,517914,33814,0,0,0
572880,application_1508364558011_28003,1,62498,62498,572880,510382,510382,34201,0,0,0
573540,application_1506638472019_5947,8,16160,16160,573540,557380,557380,35568,0,0,0
573590,application_1506638472019_32727,1,33434,33434,573590,540156,540156,35462,0,0,0
573740,application_1506638472019_5946,8,16159,16159,573740,557581,557581,36382,0,0,0
574790,application_1513627406021_2127,8,122053,122053,574790,452737,452737,32609,0,0,0
575100,application_1512440382012_0168,1,105413,105413,575100,469687,469687,32017,0,0,0
576620,application_1511916184019_3755,2,105076,105076,576620,471544,471544,42622,0,0,0
576700,application_1506638472019_7906,1,17269,17269,576700,559431,559431,36911,0,0,0
577800,application_1513025660013_0771,1,116272,116272,577800,461528,461528,31961,0,0,0
578450,application_1508364558011_5419,4,39924,39924,578450,538526,538526,28419,0,0,0
578740,application_1508364558011_17699,1,47695,47695,578740,531045,531045,33838,0,0,0
583070,application_1508364558011_47138,1,80251,80251,583070,502819,502819,34948,0,0,0
583390,application_1506638472019_7965,1,17274,17274,583390,566116,566116,38296,0,0,0
583400,application_1508364558011_42345,1,76237,76237,583400,507163,507163,33734,0,0,0
584100,application_1511528684064_1047,16,94667,94667,584100,489433,489433,57659,0,0,0
584120,application_1508364558011_18484,1,47976,47976,584120,536144,536144,35212,0,0,0
585160,application_1508364558011_46588,1,79544,79544,585160,505616,505616,34816,0,0,0
587120,application_1506638472019_14302,2,20537,20537,587120,566583,566583,50128,0,0,0
587440,application_1508364558011_43014,8,77007,77007,587440,510433,510433,35255,0,0,0
588280,application_1506638472019_24401,1,27617,27617,588280,560663,560663,37813,0,0,0
589120,application_1506638472019_14737,2,21630,21630,589120,567490,567490,47465,0,0,0
589730,application_1508364558011_51308,1,87398,87398,589730,502332,502332,34674,0,0,0
590370,application_1508364558011_4525,4,39606,39606,590370,550764,550764,38298,0,0,0
590430,application_1506638472019_2599,4,13270,13270,590430,577160,577160,36253,0,0,0
590760,application_1508364558011_36565,4,70878,70878,590760,519882,519882,30323,0,0,0
590940,application_1508364558011_49301,8,85418,85418,590940,505522,505522,37337,0,0,0
591870,application_1508364558011_48663,1,84614,84614,591870,507256,507256,36577,0,0,0
591950,application_1508364558011_12750,1,43642,43642,591950,548308,548308,35759,0,0,0
592580,application_1512440382012_0050,2,105255,105255,592580,487325,487325,44790,0,0,0
593360,application_1508364558011_49530,1,86012,86012,593360,507348,507348,36981,0,0,0
593410,application_1506638472019_7940,1,17272,17272,593410,576138,576138,37907,0,0,0
595090,application_1508364558011_51355,1,87461,87461,595090,507629,507629,36572,0,0,0
595990,application_1508364558011_21328,4,50713,50713,595990,545277,545277,36042,0,0,0
596780,application_1508364558011_48659,1,84614,84614,596780,512166,512166,36567,0,0,0
596900,application_1508364558011_47075,1,80184,80184,596900,516716,516716,36751,0,0,0
597920,application_1508364558011_48654,1,84612,84612,597920,513308,513308,36731,0,0,0
598020,application_1512440382012_1201,1,107031,107031,598020,490989,490989,35561,0,0,0
598320,application_1513025660013_2495,1,116955,116955,598320,481365,481365,36609,0,0,0
598750,application_1511916184019_1370,4,99434,99434,598750,499316,499316,33048,0,0,0
600480,application_1508364558011_47055,1,80165,80165,600480,520315,520315,36801,0,0,0
602520,application_1513025660013_0627,1,115944,115944,602520,486576,486576,37772,0,0,0
604330,application_1506638472019_1746,1,10409,10409,604330,593921,593921,42557,0,0,0
604540,application_1511528684064_0727,1,93796,93796,604540,510744,510744,37937,0,0,0
604550,application_1506638472019_38408,1,36281,36281,604550,568269,568269,38668,0,0,0
604600,application_1504131676014_21603,1,4686,4686,604600,599914,599914,48182,0,0,0
605350,application_1506638472019_35038,1,34769,34769,605350,570581,570581,40467,0,0,0
605890,application_1511916184019_1132,16,98936,98936,605890,506954,506954,64641,0,0,0
607360,application_1511916184019_0308,4,96967,96967,607360,510393,510393,35232,0,0,0
607870,application_1512440382012_2595,1,109306,109306,607870,498564,498564,36659,0,0,0
608310,application_1508364558011_23669,1,56073,56073,608310,552237,552237,39325,0,0,0
608710,application_1508364558011_18770,8,48053,48053,608710,560657,560657,42085,0,0,0
609140,application_1506638472019_0090,1,8688,8688,609140,600452,600452,44506,0,0,0
610330,application_1508364558011_28295,1,63706,63706,610330,546624,546624,40441,0,0,0
610930,application_1508364558011_50198,4,86775,86775,610930,524155,524155,33666,0,0,0
612060,application_1511528684064_0059,1,90375,90375,612060,521685,521685,39640,0,0,0
612350,application_1506638472019_12886,1,19703,19703,612350,592647,592647,41636,0,0,0
612650,application_1506638472019_32725,1,33434,33434,612650,579216,579216,41770,0,0,0
612750,application_1508364558011_41491,1,74974,74974,612750,537776,537776,38586,0,0,0
615460,application_1508364558011_17983,8,47897,47897,615460,567563,567563,47444,0,0,0
616040,application_1506638472019_4222,2,14686,15843,616040,600197,601354,60949,1157,0,0
617230,application_1511916184019_2845,8,103162,103162,617230,514068,514068,41652,0,0,0
617610,application_1506638472019_27639,1,28826,28826,617610,588784,588784,42926,0,0,0
617840,application_1506638472019_8062,1,17286,17286,617840,600554,600554,42907,0,0,0
618570,application_1508364558011_46029,1,79072,79072,618570,539498,539498,40384,0,0,0
620580,application_1508364558011_28544,1,64338,64338,620580,556242,556242,41312,0,0,0
621670,application_1508364558011_27144,1,60053,60053,621670,561617,561617,42066,0,0,0
622410,application_1508364558011_21314,4,50662,50662,622410,571748,571748,35670,0,0,0
622670,application_1511916184019_3628,8,104779,104779,622670,517891,517891,45797,0,0,0
625170,application_1508364558011_24370,1,56828,56828,625170,568342,568342,43252,0,0,0
625620,application_1508364558011_29116,1,65311,65311,625620,560309,560309,43423,0,0,0
626410,application_1508364558011_47404,4,80550,80550,626410,545860,545860,39155,0,0,0
626730,application_1508364558011_29106,1,65309,65309,626730,561421,561421,44229,0,0,0
626800,application_1511916184019_2762,2,102758,102758,626800,524042,524042,46136,0,0,0
627230,application_1506638472019_8109,1,17289,17289,627230,609941,609941,45718,0,0,0
628610,application_1508364558011_2643,1,39043,39043,628610,589567,589567,42961,0,0,0
628680,application_1508364558011_29097,1,65308,65308,628680,563372,563372,43648,0,0,0
628730,application_1506638472019_22620,1,26907,26907,628730,601823,601823,45383,0,0,0
628940,application_1512440382012_1515,16,107817,107817,628940,521123,521123,76084,0,0,0
629660,application_1506638472019_29801,1,30406,30406,629660,599254,599254,44546,0,0,0
630290,application_1506638472019_1708,4,10296,10296,630290,619994,619994,42984,0,0,0
630830,application_1508364558011_31565,1,67791,67791,630830,563039,563039,42956,0,0,0
630990,application_1508364558011_46886,1,79888,79888,630990,551102,551102,44438,0,0,0
631050,application_1506638472019_7817,1,17263,17263,631050,613787,613787,45690,0,0,0
631560,application_1508364558011_51324,1,87408,87408,631560,544152,544152,44164,0,0,0
632560,application_1511528684064_0368,16,91894,91894,632560,540666,540666,81681,0,0,0
633040,application_1506638472019_20288,8,25583,25583,633040,607457,607457,46253,0,0,0
633210,application_1508364558011_45992,1,79063,79063,633210,554147,554147,44036,0,0,0
633990,application_1506638472019_26348,1,28350,28350,633990,605640,605640,45478,0,0,0
634090,application_1506638472019_12907,1,19728,19728,634090,614362,614362,45558,0,0,0
634110,application_1506638472019_21168,8,26216,26216,634110,607894,607894,42985,0,0,0
634270,application_1508364558011_27147,1,60053,60053,634270,574217,574217,43802,0,0,0
634730,application_1508364558011_29129,1,65313,65313,634730,569417,569417,44454,0,0,0
634890,application_1506638472019_26383,1,28352,28352,634890,606538,606538,46658,0,0,0
637930,application_1506638472019_26343,1,28349,28349,637930,609581,609581,45869,0,0,0
639640,application_1508364558011_48504,8,84570,84570,639640,555070,555070,47240,0,0,0
639790,application_1512440382012_4306,1,109912,109912,639790,529878,529878,45306,0,0,0
640540,application_1511916184019_2078,1,100691,100691,640540,539849,539849,43513,0,0,0
642820,application_1508364558011_27442,1,60473,60473,642820,582347,582347,46622,0,0,0
642920,application_1506638472019_37338,1,35862,35862,642920,607058,607058,47797,0,0,0
643020,application_1512440382012_0573,1,106127,106127,643020,536893,536893,45104,0,0,0
643390,application_1504131676014_19317,1,2225,2225,643390,641165,641165,55745,0,0,0
643740,application_1506638472019_26356,1,28350,28350,643740,615390,615390,47916,0,0,0
645880,application_1506638472019_26370,1,28351,28351,645880,617529,617529,47973,0,0,0
646710,application_1512440382012_1176,1,106986,106986,646710,539724,539724,46213,0,0,0
647370,application_1504131676014_24389,1,6753,6753,647370,640617,640617,54676,0,0,0
647800,application_1506638472019_7827,4,17263,17263,647800,630537,630537,42132,0,0,0
648090,application_1508364558011_23556,1,56069,56069,648090,592021,592021,46887,0,0,0
649400,application_1508364558011_24725,1,57342,57342,649400,592058,592058,48018,0,0,0
649450,application_1506638472019_8076,1,17286,17286,649450,632164,632164,49645,0,0,0
650410,application_1506638472019_3999,4,14240,14240,650410,636170,636170,43424,0,0,0
650730,application_1506638472019_17594,1,24238,24238,650730,626492,626492,51069,0,0,0
652760,application_1508364558011_28859,1,64916,64916,652760,587844,587844,47285,0,0,0
653640,application_1508364558011_23574,1,56070,56070,653640,597570,597570,48212,0,0,0
655580,application_1511916184019_2113,1,100741,100741,655580,554839,554839,49708,0,0,0
656060,application_1511916184019_0499,1,97642,97642,656060,558418,558418,49708,0,0,0
656090,application_1504131676014_22965,4,5937,5937,656090,650153,650153,53879,0,0,0
656690,application_1508364558011_46559,1,79510,79510,656690,577180,577180,50210,0,0,0
656710,application_1508364558011_31371,1,67547,67547,656710,589163,589163,50529,0,0,0
656980,application_1508364558011_0553,1,37631,37631,656980,619349,619349,50535,0,0,0
657360,application_1511916184019_2836,1,103126,103126,657360,554234,554234,49208,0,0,0
657970,application_1508364558011_0225,1,37386,37386,657970,620584,620584,50186,0,0,0
658150,application_1512440382012_0485,1,105951,105951,658150,552199,552199,49300,0,0,0
658500,application_1512440382012_5681,1,111550,111550,658500,546950,546950,48682,0,0,0
660460,application_1506638472019_2714,4,13304,13304,660460,647156,647156,48529,0,0,0
660960,application_1508364558011_22210,4,53142,53142,660960,607818,607818,48985,0,0,0
661070,application_1506638472019_22642,1,26908,26908,661070,634162,634162,53018,0,0,0
661540,application_1508364558011_33982,1,69718,69718,661540,591822,591822,51924,0,0,0
662330,application_1511916184019_2810,1,103032,103032,662330,559298,559298,50168,0,0,0
662620,application_1508364558011_0804,1,37866,37866,662620,624754,624754,50088,0,0,0
662690,application_1508364558011_18764,8,48037,48037,662690,614653,614653,52440,0,0,0
662720,application_1511916184019_2326,1,101312,101312,662720,561408,561408,50837,0,0,0
662820,application_1508364558011_23102,4,55666,55666,662820,607154,607154,45875,0,0,0
662920,application_1511528684064_0506,1,92675,92675,662920,570245,570245,49738,0,0,0
663370,application_1511916184019_2445,1,101444,101444,663370,561926,561926,50255,0,0,0
663450,application_1512440382012_0480,1,105951,105951,663450,557499,557499,51977,0,0,0
663510,application_1511528684064_0373,1,91927,91927,663510,571583,571583,49441,0,0,0
664180,application_1511916184019_1111,1,98868,98868,664180,565312,565312,50462,0,0,0
665520,application_1508364558011_46457,1,79370,79370,665520,586150,586150,51453,0,0,0
665930,application_1508364558011_36045,4,70323,70323,665930,595607,595607,45479,0,0,0
666580,application_1512440382012_5023,1,110406,110406,666580,556174,556174,53044,0,0,0
668270,application_1504131676014_21663,1,4783,4783,668270,663487,663487,61811,0,0,0
668350,application_1508364558011_28641,1,64611,64611,668350,603739,603739,53527,0,0,0
668460,application_1506638472019_22665,1,26909,26909,668460,641551,641551,53251,0,0,0
669280,application_1511528684064_1342,1,95199,95199,669280,574081,574081,50298,0,0,0
669630,application_1504131676014_16904,8,1088,1088,669630,668542,668542,65782,0,0,0
670440,application_1506638472019_34955,2,34661,34661,670440,635779,635779,62497,0,0,0
670570,application_1506638472019_10383,1,18365,18365,670570,652205,652205,54407,0,0,0
670710,application_1508364558011_21635,2,50860,50860,670710,619850,619850,64910,0,0,0
670880,application_1512440382012_1795,1,108226,108226,670880,562654,562654,50590,0,0,0
671200,application_1506638472019_4068,1,14340,14340,671200,656860,656860,55441,0,0,0
671340,application_1511916184019_2606,1,102160,102160,671340,569180,569180,52152,0,0,0
671740,application_1511916184019_1024,1,98606,98606,671740,573134,573134,53686,0,0,0
671800,application_1511916184019_1183,1,99038,99038,671800,572762,572762,52655,0,0,0
671900,application_1508364558011_47228,1,80447,80447,671900,591453,591453,53385,0,0,0
671900,application_1508364558011_48689,1,84675,84675,671900,587225,587225,52844,0,0,0
671980,application_1513627406021_0575,1,118721,118721,671980,553259,553259,55659,0,0,0
672080,application_1508364558011_12374,1,43555,43555,672080,628525,628525,53823,0,0,0
672580,application_1508364558011_47498,1,80631,80631,672580,591949,591949,54163,0,0,0
672740,application_1508364558011_52063,1,88075,88075,672740,584665,584665,53376,0,0,0
673660,application_1508364558011_33666,8,69538,69538,673660,604122,604122,52825,0,0,0
673840,application_1513627406021_0187,32,118202,673670,673840,170,555638,4,555468,0,0
675930,application_1511528684064_0872,8,94148,94148,675930,581782,581782,51095,0,0,0
676130,application_1508364558011_21596,1,50831,50831,676130,625299,625299,54620,0,0,0
676500,application_1508364558011_50201,4,86775,86775,676500,589725,589725,53727,0,0,0
676960,application_1506638472019_5808,8,15915,15915,676960,661045,661045,54025,0,0,0
677240,application_1511916184019_0093,1,96591,96591,677240,580649,580649,53966,0,0,0
677680,application_1512440382012_0483,1,105951,105951,677680,571729,571729,53256,0,0,0
678080,application_1512440382012_2458,1,109060,109060,678080,569020,569020,54979,0,0,0
678920,application_1508364558011_51987,1,87960,87960,678920,590960,590960,52779,0,0,0
679420,application_1511916184019_2704,32,102549,673870,679420,5550,576871,829,571321,0,0
680830,application_1506638472019_38223,1,36243,36243,680830,644587,644587,53568,0,0,0
681380,application_1508364558011_37061,1,72059,72059,681380,609321,609321,55904,0,0,0
681500,application_1506638472019_2417,1,12541,12541,681500,668959,668959,58543,0,0,0
681590,application_1511916184019_2717,32,102561,673670,681590,7920,579029,1260,571109,0,0
682220,application_1508364558011_40717,1,74307,74307,682220,607913,607913,56082,0,0,0
682260,application_1508364558011_23558,1,56069,56069,682260,626191,626191,54752,0,0,0
682350,application_1508364558011_48487,8,84568,84568,682350,597782,597782,56790,0,0,0
682620,application_1508364558011_0554,1,37631,37631,682620,644989,644989,55700,0,0,0
682740,application_1508364558011_12950,8,43891,43891,682740,638849,638849,55867,0,0,0
683560,application_1508364558011_50347,1,86973,86973,683560,596587,596587,53315,0,0,0
688320,application_1506638472019_38203,1,36240,36240,688320,652080,652080,56266,0,0,0
688320,application_1506638472019_8155,1,17293,17293,688320,671027,671027,57954,0,0,0
688410,application_1511916184019_2626,1,102237,102237,688410,586173,586173,55082,0,0,0
688980,application_1508364558011_47411,4,80551,80551,688980,608429,608429,51722,0,0,0
689110,application_1506638472019_7797,1,17261,17261,689110,671849,671849,58034,0,0,0
689650,application_1508364558011_43221,1,77441,77441,689650,612209,612209,54999,0,0,0
690220,application_1508364558011_14701,1,45246,45246,690220,644974,644974,54571,0,0,0
690630,application_1511528684064_0486,8,92592,92592,690630,598038,598038,58892,0,0,0
690920,application_1508364558011_51336,8,87422,87422,690920,603498,603498,57242,0,0,0
691110,application_1506638472019_27646,1,28832,28832,691110,662278,662278,58938,0,0,0
692360,application_1513025660013_0505,32,115667,673700,692360,18660,576693,3165,558033,0,0
692510,application_1508364558011_42018,1,75715,75715,692510,616795,616795,56111,0,0,0
694260,application_1508364558011_42014,1,75707,75707,694260,618553,618553,56270,0,0,0
695320,application_1511528684064_0733,8,93814,93814,695320,601506,601506,57221,0,0,0
695690,application_1506638472019_1720,4,10355,10355,695690,685335,685335,55847,0,0,0
696290,application_1506638472019_37574,1,35962,35962,696290,660328,660328,59990,0,0,0
698610,application_1506638472019_7856,1,17265,17265,698610,681345,681345,59119,0,0,0
699150,application_1506638472019_26347,1,28349,28349,699150,670801,670801,58705,0,0,0
699360,application_1506638472019_6269,1,16993,16993,699360,682367,682367,59523,0,0,0
699370,application_1508364558011_41627,8,75204,75204,699370,624166,624166,53305,0,0,0
699730,application_1506638472019_6059,4,16420,16420,699730,683310,683310,55655,0,0,0
700220,application_1513025660013_0883,32,116443,676530,700220,23690,583777,4619,560087,0,0
700660,application_1508364558011_0268,1,37418,37418,700660,663242,663242,58504,0,0,0
701210,application_1508364558011_0658,4,37790,37790,701210,663420,663420,54761,0,0,0
702250,application_1506638472019_1686,1,10214,10214,702250,692036,692036,62472,0,0,0
703620,application_1512440382012_0608,1,106153,106153,703620,597467,597467,57445,0,0,0
703700,application_1506638472019_7839,1,17264,17264,703700,686436,686436,59203,0,0,0
703740,application_1508364558011_45687,32,78499,673670,703740,30070,625241,6022,595171,0,0
703770,application_1512440382012_0778,1,106383,106383,703770,597387,597387,57442,0,0,0
704360,application_1508364558011_52577,1,88651,88651,704360,615709,615709,60523,0,0,0
704370,application_1506638472019_26345,1,28349,28349,704370,676021,676021,61010,0,0,0
704730,application_1511916184019_1973,1,100420,100420,704730,604310,604310,58725,0,0,0
705740,application_1506638472019_7882,1,17267,17267,705740,688473,688473,60613,0,0,0
705860,application_1511916184019_2090,1,100710,100710,705860,605150,605150,59304,0,0,0
706070,application_1508364558011_35201,1,69948,69948,706070,636122,636122,60317,0,0,0
706580,application_1506638472019_14698,2,21628,21628,706580,684952,684952,73024,0,0,0
706950,application_1508364558011_15487,1,45774,45774,706950,661176,661176,61553,0,0,0
707600,application_1506638472019_2528,8,13017,13017,707600,694583,694583,63823,0,0,0
708830,application_1508364558011_50202,4,86775,86775,708830,622055,622055,55888,0,0,0
709270,application_1508364558011_21638,1,50872,50872,709270,658398,658398,63089,0,0,0
710170,application_1506638472019_7921,1,17270,17270,710170,692900,692900,62412,0,0,0
710470,application_1506638472019_33680,1,34330,34330,710470,676140,676140,61351,0,0,0
711130,application_1512440382012_0087,8,105257,105257,711130,605873,605873,67116,0,0,0
711150,application_1508364558011_41032,4,74662,74662,711150,636488,636488,57134,0,0,0
711160,application_1508364558011_15590,1,45919,45919,711160,665241,665241,61111,0,0,0
711290,application_1508364558011_27696,1,61421,61421,711290,649869,649869,62434,0,0,0
711470,application_1508364558011_24368,1,56818,56818,711470,654652,654652,63436,0,0,0
711690,application_1508364558011_24743,1,57349,57349,711690,654341,654341,61089,0,0,0
712230,application_1512440382012_1594,1,107948,107948,712230,604282,604282,60477,0,0,0
712470,application_1506638472019_35917,1,35048,35048,712470,677422,677422,63341,0,0,0
712930,application_1508364558011_35014,1,69882,69882,712930,643048,643048,62980,0,0,0
713090,application_1512440382012_0579,1,106134,106134,713090,606956,606956,63360,0,0,0
714090,application_1506638472019_34984,1,34670,34670,714090,679420,679420,63270,0,0,0
714340,application_1511528684064_2142,8,96146,96146,714340,618194,618194,60240,0,0,0
714750,application_1506638472019_20014,1,25115,25115,714750,689635,689635,65890,0,0,0
714910,application_1506638472019_1988,4,11341,11341,714910,703569,703569,62458,0,0,0
716030,application_1506638472019_29798,1,30400,30400,716030,685630,685630,63484,0,0,0
716110,application_1512440382012_0275,1,105548,105548,716110,610562,610562,60344,0,0,0
716670,application_1504131676014_15229,8,437,437,716670,716233,716233,80124,0,0,0
717040,application_1508364558011_30287,8,66614,66614,717040,650426,650426,65196,0,0,0
717340,application_1512440382012_5196,1,110517,110517,717340,606823,606823,61310,0,0,0
717390,application_1511916184019_1171,1,99037,99037,717390,618353,618353,61418,0,0,0
717450,application_1508364558011_36271,1,70518,70518,717450,646932,646932,61685,0,0,0
717640,application_1506638472019_26390,1,28352,28352,717640,689288,689288,64207,0,0,0
717910,application_1511528684064_1030,1,94619,94619,717910,623291,623291,63362,0,0,0
718000,application_1508364558011_6330,1,40635,40635,718000,677365,677365,62354,0,0,0
718030,application_1508364558011_3768,1,39285,39285,718030,678745,678745,62696,0,0,0
719090,application_1506638472019_8089,1,17288,17288,719090,701802,701802,68194,0,0,0
719830,application_1506638472019_38604,1,36372,36372,719830,683458,683458,64664,0,0,0
720470,application_1508364558011_6335,1,40638,40638,720470,679832,679832,65558,0,0,0
720610,application_1512440382012_3950,1,109846,109846,720610,610764,610764,63483,0,0,0
720780,application_1506638472019_14740,2,21630,21630,720780,699150,699150,79264,0,0,0
721330,application_1508364558011_47546,1,80741,80741,721330,640589,640589,63565,0,0,0
721400,application_1511528684064_1324,8,95169,95169,721400,626231,626231,69480,0,0,0
721600,application_1508364558011_22983,8,55118,55118,721600,666482,666482,63676,0,0,0
722410,application_1506638472019_14660,2,21626,21626,722410,700784,700784,75429,0,0,0
723420,application_1508364558011_52373,1,88285,88285,723420,635135,635135,65232,0,0,0
724520,application_1512440382012_0396,4,105701,105701,724520,618819,618819,62852,0,0,0
724710,application_1513025660013_0819,32,116340,673670,724710,51040,608370,14262,557330,0,0
725050,application_1508364558011_36152,4,70447,70447,725050,654603,654603,59878,0,0,0
725190,application_1508364558011_0014,2,37286,37286,725190,687904,687904,73625,0,0,0
725700,application_1511916184019_2013,8,100515,100515,725700,625185,625185,66147,0,0,0
725770,application_1506638472019_8100,1,17288,17288,725770,708482,708482,66449,0,0,0
726020,application_1506638472019_14652,2,21625,21625,726020,704395,704395,78269,0,0,0
726340,application_1506638472019_27787,1,29018,29018,726340,697322,697322,67334,0,0,0
726460,application_1506638472019_29790,1,30363,30363,726460,696097,696097,69279,0,0,0
727680,application_1508364558011_47085,1,80195,80195,727680,647485,647485,69138,0,0,0
728240,application_1506638472019_14668,2,21626,21626,728240,706614,706614,79819,0,0,0
728850,application_1506638472019_14707,2,21628,21628,728850,707222,707222,80225,0,0,0
729160,application_1508364558011_46329,8,79261,79261,729160,649899,649899,69863,0,0,0
730140,application_1506638472019_2507,1,12947,12947,730140,717193,717193,72118,0,0,0
730170,application_1506638472019_32141,1,33166,33166,730170,697004,697004,67584,0,0,0
732060,application_1506638472019_27772,1,28988,28988,732060,703072,703072,69537,0,0,0
732290,application_1506638472019_14658,2,21625,21625,732290,710665,710665,84500,0,0,0
733200,application_1508364558011_22509,1,54211,54211,733200,678989,678989,69197,0,0,0
733810,application_1506638472019_24471,1,27675,27675,733810,706135,706135,75181,0,0,0
735000,application_1512440382012_5620,1,111248,111248,735000,623752,623752,70068,0,0,0
735450,application_1512440382012_0363,1,105619,105619,735450,629831,629831,70577,0,0,0
736460,application_1506638472019_12701,8,19543,19543,736460,716917,716917,79454,0,0,0
736780,application_1506638472019_2541,1,13093,13093,736780,723687,723687,74518,0,0,0
737040,application_1508364558011_23109,1,55679,55679,737040,681361,681361,71154,0,0,0
737720,application_1506638472019_2540,1,13092,13092,737720,724628,724628,73421,0,0,0
738250,application_1506638472019_26340,1,28349,28349,738250,709901,709901,73070,0,0,0
738650,application_1508364558011_25166,1,57427,57427,738650,681223,681223,73260,0,0,0
738970,application_1506638472019_3725,8,13699,13699,738970,725271,725271,79115,0,0,0
739370,application_1504131676014_25108,4,8123,8123,739370,731247,731247,78463,0,0,0
739620,application_1506638472019_3979,4,14181,14181,739620,725439,725439,63235,0,0,0
739830,application_1506638472019_2539,1,13091,13091,739830,726739,726739,74437,0,0,0
739860,application_1506638472019_3723,8,13698,13698,739860,726162,726162,83514,0,0,0
739940,application_1508364558011_50203,4,86775,86775,739940,653165,653165,62590,0,0,0
740250,application_1508364558011_31469,4,67635,67635,740250,672615,672615,66093,0,0,0
742110,application_1508364558011_1469,1,38692,38692,742110,703418,703418,76805,0,0,0
742210,application_1508364558011_0258,8,37415,37415,742210,704795,704795,78787,0,0,0
744110,application_1508364558011_49289,8,85404,85404,744110,658706,658706,85702,0,0,0
745020,application_1511528684064_1263,1,95057,95057,745020,649963,649963,77182,0,0,0
745310,application_1508364558011_40269,1,73878,73878,745310,671432,671432,75413,0,0,0
745950,application_1506638472019_10592,8,18584,18584,745950,727366,727366,84065,0,0,0
746560,application_1506638472019_27754,1,28948,28948,746560,717612,717612,78823,0,0,0
746670,application_1506638472019_13914,1,19917,19917,746670,726753,726753,78382,0,0,0
746830,application_1506638472019_22663,1,26909,26909,746830,719921,719921,80228,0,0,0
747560,application_1506638472019_7918,1,17270,17270,747560,730290,730290,81604,0,0,0
747590,application_1508364558011_12947,8,43891,43891,747590,703699,703699,80907,0,0,0
747660,application_1508364558011_28880,1,64936,64936,747660,682724,682724,77483,0,0,0
748270,application_1508364558011_27769,8,61617,61617,748270,686653,686653,83326,0,0,0
748930,application_1506638472019_32150,1,33168,33168,748930,715762,715762,81217,0,0,0
749130,application_1508364558011_35983,1,70221,70221,749130,678909,678909,81340,0,0,0
749150,application_1506638472019_7835,1,17264,17264,749150,731886,731886,78065,0,0,0
749230,application_1508364558011_35957,1,70190,70190,749230,679040,679040,77582,0,0,0
750520,application_1506638472019_2334,1,12064,12064,750520,738456,738456,83937,0,0,0
750870,application_1506638472019_17514,4,24071,24071,750870,726799,726799,82710,0,0,0
750960,application_1512440382012_1164,4,106964,106964,750960,643996,643996,81182,0,0,0
752810,application_1508364558011_40977,1,74583,74583,752810,678227,678227,80005,0,0,0
752870,application_1508364558011_45652,1,78399,78399,752870,674471,674471,78378,0,0,0
753120,application_1508364558011_28071,1,62875,62875,753120,690245,690245,84501,0,0,0
753150,application_1508364558011_23545,1,56069,56069,753150,697081,697081,81658,0,0,0
753570,application_1508364558011_36562,4,70878,70878,753570,682692,682692,78347,0,0,0
753880,application_1508364558011_24723,1,57340,57340,753880,696540,696540,83933,0,0,0
754020,application_1506638472019_7922,1,17270,17270,754020,736750,736750,83726,0,0,0
754090,application_1512440382012_2020,1,108483,108483,754090,645607,645607,85304,0,0,0
755640,application_1513025660013_2780,1,117441,117441,755640,638199,638199,84259,0,0,0
756090,application_1512440382012_2460,1,109061,109061,756090,647029,647029,80677,0,0,0
757180,application_1512440382012_1262,1,107166,107166,757180,650014,650014,82730,0,0,0
757270,application_1508364558011_49153,1,85213,85213,757270,672057,672057,83436,0,0,0
757400,application_1512440382012_0599,1,106152,106152,757400,651248,651248,85384,0,0,0
757530,application_1506638472019_38255,1,36248,36248,757530,721282,721282,82059,0,0,0
757620,application_1508364558011_46317,1,79243,79243,757620,678377,678377,83487,0,0,0
759510,application_1512440382012_6228,1,113905,113905,759510,645605,645605,84338,0,0,0
761220,application_1508364558011_23696,1,56074,56074,761220,705146,705146,86126,0,0,0
761750,application_1508364558011_21539,4,50774,50774,761750,710976,710976,79510,0,0,0
774080,application_1508364558011_21598,4,50832,50832,774080,723248,723248,82650,0,0,0
774830,application_1512440382012_3429,4,109676,109676,774830,665154,665154,77827,0,0,0
777990,application_1508364558011_27859,32,61990,673700,777990,104290,716000,55944,611710,0,0
794160,application_1508364558011_17514,32,47511,673670,794160,120490,746649,71514,626159,0,0
